あいの里教育大駅	北海道
あいの里公園駅	北海道
相内駅	北海道
愛別駅	北海道
青葉駅	北海道
赤井川駅	北海道
赤平駅	北海道
旭川駅	北海道
旭川四条駅	北海道
朝里駅	北海道
芦別駅	北海道
厚岸駅	北海道
厚床駅	北海道
厚内駅	北海道
厚別駅	北海道
姉別駅	北海道
網走駅	北海道
安平駅	北海道
安足間駅	北海道
伊香牛駅	北海道
生田原駅	北海道
池田駅	北海道
石狩沼田駅	北海道
石倉駅	北海道
磯分内駅	北海道
糸井駅	北海道
愛し野駅	北海道
稲積公園駅	北海道
稲穂駅	北海道
岩見沢駅	北海道
植苗駅	北海道
有珠駅	北海道
浦幌駅	北海道
恵庭駅	北海道
江部乙駅	北海道
江別駅	北海道
遠軽駅	北海道
追分駅	北海道	秋田県
大麻駅	北海道
大岸駅	北海道
大中山駅	北海道
大沼駅	北海道
大沼公園駅	北海道
奥津軽いまべつ駅	青森県
筬島駅	北海道
長都駅	北海道
納内駅	北海道
渡島砂原駅	北海道
渡島沼尻駅	北海道
長万部駅	北海道
尾白内駅	北海道
大楽毛駅	北海道
小樽駅	北海道
小樽築港駅	北海道
落石駅	北海道
音威子府駅	北海道
落部駅	北海道
帯広駅	北海道
尾幌駅	北海道
音別駅	北海道
掛澗駅	北海道
学田駅	北海道
神楽岡駅	北海道
桂台駅	北海道
兜沼駅	北海道
上芦別駅	北海道
上尾幌駅	北海道
上川駅	北海道
上野幌駅	北海道
上富良野駅	北海道
上幌向駅	北海道
茅沼駅	北海道
川端駅	北海道
川湯温泉駅	北海道
桔梗駅	北海道
木古内駅	北海道
北一已駅	北海道
北秩父別駅	北海道
北永山駅	北海道
北浜駅	北海道
北美瑛駅	北海道
北広島駅	北海道
北舟岡駅	北海道
北見駅	北海道
北吉原駅	北海道
清里町駅	北海道
銀山駅	北海道
釧路駅	北海道
釧路湿原駅	北海道
倶知安駅	北海道
栗丘駅	北海道
栗沢駅	北海道
栗山駅	北海道
黒岩駅	北海道
黒松内駅	北海道
国縫駅	北海道
原生花園(臨)駅	北海道
剣淵駅	北海道
光珠内駅	北海道
黄金駅	北海道
小沢駅	北海道
虎杖浜駅	北海道
琴似駅	北海道
小幌駅	北海道
駒ヶ岳駅	北海道
五稜郭駅	北海道
昆布駅	北海道
昆布盛駅	北海道
崎守駅	北海道
佐久駅	北海道
桜岡駅	北海道
咲来駅	北海道
札弦駅	北海道
札内駅	北海道
札幌駅	北海道
サッポロビール庭園駅	北海道
塩狩駅	北海道
塩谷駅	北海道
鹿討駅	北海道
鹿部駅	北海道
然別駅	北海道
静狩駅	北海道
篠路駅	北海道
志文駅	北海道
標茶駅	北海道
士別駅	北海道
島松駅	北海道
占冠駅	北海道
下沼駅	北海道
社台駅	北海道
庶路駅	北海道
白老駅	北海道
白滝駅	北海道
白糠駅	北海道
知床斜里駅	北海道
白石駅	北海道	宮城県	熊本県
新青森駅	青森県	青森県
新旭川駅	北海道
新大楽毛駅	北海道
新川駅	北海道
新琴似駅	北海道
新札幌駅	北海道
新千歳空港駅	北海道
新得駅	北海道
新函館北斗駅	北海道
新富士駅	北海道	静岡県
新夕張駅	北海道
新吉野駅	北海道
森林公園駅	北海道
砂川駅	北海道
瀬戸瀬駅	北海道
銭函駅	北海道
桑園駅	北海道
大成駅	北海道
太平駅	北海道
高砂駅	北海道
滝川駅	北海道
拓北駅	北海道
竹浦駅	北海道
伊達紋別駅	北海道
多寄駅	北海道
端野駅	北海道
智恵文駅	北海道
近文駅	北海道
秩父別駅	北海道
千歳駅	北海道	千葉県
智北駅	北海道
茶志内駅	北海道
茶内駅	北海道
千代ヶ岡駅	北海道
手稲駅	北海道
天塩川温泉駅	北海道
天塩中川駅	北海道
遠浅駅	北海道
問寒別駅	北海道
当別駅	北海道
当麻駅	北海道
洞爺駅	北海道
塘路駅	北海道
十弗駅	北海道
遠矢駅	北海道
十勝清水駅	北海道
利別駅	北海道
苫小牧駅	北海道
トマム駅	北海道
富浦駅	北海道	千葉県
豊浦駅	北海道
豊頃駅	北海道
豊富駅	北海道
豊沼駅	北海道
豊幌駅	北海道
奈井江駅	北海道
苗穂駅	北海道
中愛別駅	北海道
中小国駅	青森県	青森県
中斜里駅	北海道
中富良野駅	北海道
永山駅	北海道
長和駅	北海道
七飯駅	北海道
名寄駅	北海道
名寄高校駅	北海道
仁木駅	北海道
西帯広駅	北海道
西神楽駅	北海道
錦岡駅	北海道
西北見駅	北海道
西御料駅	北海道
西庶路駅	北海道
西聖和駅	北海道
西中駅	北海道
西瑞穂駅	北海道
西女満別駅	北海道
西留辺蘂駅	北海道
西和田駅	北海道
ニセコ駅	北海道
日進駅	北海道	埼玉県
仁山駅	北海道
糠南駅	北海道
沼ノ端駅	北海道
熱郛駅	北海道
根室駅	北海道
野花南駅	北海道
野田生駅	北海道
野幌駅	北海道
登別駅	北海道
萩野駅	北海道
柏陽駅	北海道
柏林台駅	北海道
函館駅	北海道
八軒駅	北海道
発寒駅	北海道
発寒中央駅	北海道
浜厚真駅	北海道
浜小清水駅	北海道
浜中駅	北海道
早来駅	北海道
緋牛内駅	北海道
美瑛駅	北海道
東相内駅	北海道
東旭川駅	北海道
東釧路駅	北海道
東室蘭駅	北海道
東森駅	北海道
比布駅	北海道
美唄駅	北海道
美馬牛駅	北海道
美深駅	北海道
美幌駅	北海道
平岸駅	北海道
比羅夫駅	北海道
美留和駅	北海道
風連駅	北海道
深川駅	北海道
二股駅	北海道
太美駅	北海道
富良野駅	北海道
古山駅	北海道
平和駅	北海道
別当賀駅	北海道
別保駅	北海道
母恋駅	北海道
星置駅	北海道
ほしみ駅	北海道
細岡(臨)駅	北海道
北海道医療大学駅	北海道
幌延駅	北海道
幌別駅	北海道
幌向駅	北海道
幕別駅	北海道
摩周駅	北海道
鱒浦駅	北海道
丸瀬布駅	北海道
稀府駅	北海道
御影駅	北海道
三川駅	北海道	新潟県
御崎駅	北海道
瑞穂駅	北海道
緑駅	北海道
緑が丘駅	北海道
南小樽駅	北海道
南千歳駅	北海道
南永山駅	北海道
南稚内駅	北海道
峰延駅	北海道
武佐駅	北海道
室蘭駅	北海道
恵み野駅	北海道
目名駅	北海道
女満別駅	北海道
芽室駅	北海道
藻琴駅	北海道
茂尻駅	北海道
妹背牛駅	北海道
本輪西駅	北海道
森駅	北海道
門静駅	北海道
八雲駅	北海道
安国駅	北海道
山越駅	北海道
山崎駅	北海道	京都府
止別駅	北海道
勇知駅	北海道
勇払駅	北海道
由仁駅	北海道
百合が原駅	北海道
余市駅	北海道
呼人駅	北海道
ラベンダー畑(臨)駅	北海道
蘭越駅	北海道
蘭島駅	北海道
蘭留駅	北海道
留辺蘂駅	北海道
礼文駅	北海道
ロイズタウン駅	北海道
鷲別駅	北海道
稚内駅	北海道
和寒駅	北海道
輪西駅	北海道
会津大塩駅	福島県
会津蒲生駅	福島県
会津川口駅	福島県
会津越川駅	福島県
会津坂本駅	福島県
会津塩沢駅	福島県
会津高田駅	福島県
会津豊川駅	福島県
会津中川駅	福島県
会津西方駅	福島県
会津坂下駅	福島県
会津桧原駅	福島県
会津本郷駅	福島県
会津水沼駅	福島県
会津宮下駅	福島県
会津柳津駅	福島県
会津横田駅	福島県
会津若松駅	福島県
相野々駅	秋田県
相原駅	東京都
粟生津駅	新潟県
青笹駅	岩手県
青沼駅	長野県
あおば通駅	宮城県
青堀駅	千葉県
青森駅	青森県
青柳駅	長野県
青山駅	新潟県
赤井駅	福島県
赤川駅	青森県
赤倉温泉駅	山形県
赤坂田駅	岩手県
明科駅	長野県
赤塚駅	茨城県
赤羽駅	東京都
赤渕駅	岩手県
赤湯駅	山形県
秋川駅	東京都
昭島駅	東京都
秋田駅	秋田県
あきた白神駅	秋田県
秋葉原駅	東京都
上尾駅	埼玉県
安子ケ島駅	福島県
安積永盛駅	福島県
阿佐ケ谷駅	東京都
浅草橋駅	東京都
浅野駅	神奈川県
旭駅	千葉県	高知県
足利駅	栃木県
あしかがフラワーパーク駅	栃木県
鰺ケ沢駅	青森県
足ケ瀬駅	岩手県
安食駅	千葉県
芦沢駅	山形県
足滝駅	新潟県
網代駅	静岡県
梓橋駅	長野県
安曇追分駅	長野県
安曇沓掛駅	長野県
愛宕駅	宮城県
安達駅	福島県
熱海駅	静岡県	静岡県
厚木駅	神奈川県
安比高原駅	岩手県
あつみ温泉駅	山形県
左沢駅	山形県
穴山駅	山梨県
兄畑駅	岩手県
姉ケ崎駅	千葉県
我孫子駅	千葉県
油川駅	青森県
余目駅	山形県
安茂里駅	長野県
綾織駅	岩手県
愛子駅	宮城県
綾瀬駅	東京都
荒川沖駅	茨城県
新木駅	千葉県
荒浜駅	新潟県
新屋駅	秋田県
荒屋新町駅	岩手県
荒谷前駅	岩手県
有明駅	長野県
有壁駅	宮城県
有戸駅	青森県
有畑駅	青森県
安房天津駅	千葉県
安房勝山駅	千葉県
安房鴨川駅	千葉県
安房小湊駅	千葉県
安善駅	神奈川県
安中駅	群馬県
安中榛名駅	群馬県
飯岡駅	千葉県
飯倉駅	千葉県
飯田橋駅	東京都
飯詰駅	秋田県
飯森駅	長野県
飯山駅	長野県
五十島駅	新潟県
碇ケ関駅	青森県
井川さくら駅	秋田県
軍畑駅	東京都
池月駅	宮城県
池袋駅	東京都
伊佐領駅	山形県
石和温泉駅	山梨県
石打駅	新潟県
石岡駅	茨城県
石神前駅	東京都
石川駅	青森県
石川町駅	神奈川県
石越駅	宮城県
石地駅	新潟県
石鳥谷駅	岩手県
石巻駅	宮城県
石巻あゆみ野駅	宮城県
石橋駅	栃木県
伊豆多賀駅	静岡県
泉駅	福島県
泉郷駅	福島県
泉崎駅	福島県
泉外旭川駅	秋田県
泉田駅	山形県
出雲崎駅	新潟県
伊勢崎駅	群馬県
磯子駅	神奈川県
磯原駅	茨城県
磯部駅	群馬県
潮来駅	茨城県
板橋駅	東京都
板谷駅	山形県
板柳駅	青森県
市ケ谷駅	東京都
市川駅	千葉県
市川大野駅	千葉県
市川塩浜駅	千葉県
市城駅	群馬県
一ノ関駅	岩手県
五日町駅	新潟県
伊東駅	静岡県
稲尾駅	長野県
稲城長沼駅	東京都
稲毛駅	千葉県
稲毛海岸駅	千葉県
稲田駅	茨城県
稲田堤駅	神奈川県
稲荷山駅	長野県
猪苗代駅	福島県
猪苗代湖畔(臨)駅	福島県
犬川駅	山形県
井野駅	群馬県
茨目駅	新潟県
今井駅	長野県
今泉駅	山形県
今市駅	栃木県
今川駅	新潟県
今別駅	青森県
五十川駅	山形県
入広瀬駅	新潟県
入谷駅	神奈川県
岩井駅	千葉県
いわき駅	福島県
磐城浅川駅	福島県
磐城石井駅	福島県
磐城石川駅	福島県
磐城太田駅	福島県
磐城棚倉駅	福島県
磐城常葉駅	福島県
磐城塙駅	福島県
岩城みなと駅	秋田県
磐城守山駅	福島県
岩切駅	宮城県
岩沢駅	岩手県
岩島駅	群馬県
岩宿駅	群馬県
岩瀬駅	茨城県
岩館駅	秋田県
岩原スキー場前駅	新潟県
岩手飯岡駅	岩手県
岩手上郷駅	岩手県
いわて沼宮内駅	岩手県
岩手二日町駅	岩手県
岩出山駅	宮城県
岩沼駅	宮城県
巌根駅	千葉県
岩根橋駅	岩手県
岩ノ下駅	岩手県
岩舟駅	栃木県
岩船町駅	新潟県
岩間駅	茨城県
岩村田駅	長野県
岩室駅	新潟県
岩本駅	群馬県
院内駅	秋田県
ウェスパ椿山駅	青森県
上田駅	長野県
植田駅	福島県
上野駅	東京都
上野原駅	山梨県
魚沼田中駅	新潟県
魚沼中条駅	新潟県
浮間舟渡駅	東京都
鶯谷駅	東京都
鶯野駅	秋田県
有家駅	岩手県
羽後飯塚駅	秋田県
羽後岩谷駅	秋田県
羽後牛島駅	秋田県
羽後亀田駅	秋田県
羽後境駅	秋田県
羽後長野駅	秋田県
羽後本荘駅	秋田県
羽後四ツ屋駅	秋田県
宇佐美駅	静岡県
氏家駅	栃木県
牛久駅	茨城県
牛浜駅	東京都
後潟駅	青森県
鵜杉駅	山形県
臼田駅	長野県
羽前大山駅	山形県
羽前金沢駅	山形県
羽前小松駅	山形県
羽前前波駅	山形県
羽前高松駅	山形県
羽前千歳駅	山形県
羽前椿駅	山形県
羽前豊里駅	山形県
羽前長崎駅	山形県
羽前中山駅	山形県
羽前沼沢駅	山形県
羽前松岡駅	山形県
羽前水沢駅	山形県
羽前山辺駅	山形県
内ケ巻駅	新潟県
内郷駅	福島県
内野駅	新潟県
内野西が丘駅	新潟県
内原駅	茨城県
宇都宮駅	栃木県
祖母島駅	群馬県
姥堂駅	福島県
鵜原駅	千葉県
海芝浦駅	神奈川県
海尻駅	長野県
海ノ口駅	長野県
梅ケ沢駅	宮城県
浦佐駅	新潟県
浦宿駅	宮城県
浦和駅	埼玉県
瓜連駅	茨城県
漆山駅	山形県
江田駅	福島県
越後赤塚駅	新潟県
越後石山駅	新潟県
越後岩沢駅	新潟県
越後岩塚駅	新潟県
越後大島駅	新潟県
越後片貝駅	新潟県
越後金丸駅	新潟県
越後川口駅	新潟県
越後寒川駅	新潟県
越後鹿渡駅	新潟県
越後下関駅	新潟県
越後須原駅	新潟県
越後曽根駅	新潟県
越後滝谷駅	新潟県
越後田沢駅	新潟県
越後田中駅	新潟県
越後中里駅	新潟県
越後早川駅	新潟県
越後広瀬駅	新潟県
越後広田駅	新潟県
越後堀之内駅	新潟県
越後水沢駅	新潟県
越後湯沢駅	新潟県
越中島駅	東京都
江釣子駅	岩手県
榎戸駅	千葉県
恵比寿駅	東京都
海老名駅	神奈川県
江見駅	千葉県
塩山駅	山梨県
笈川駅	福島県
置賜駅	山形県
追良瀬駅	青森県
扇田駅	秋田県
扇町駅	神奈川県
王子駅	東京都
青海川駅	新潟県
青梅駅	東京都
大網駅	千葉県
大石田駅	山形県
大磯駅	神奈川県
大井町駅	東京都
大形駅	新潟県
大金駅	栃木県
大釜駅	岩手県
大川駅	神奈川県
大川平駅	青森県
大河原駅	宮城県	京都府
大久喜駅	青森県
大口駅	神奈川県
大久保駅	秋田県	東京都	兵庫県
逢隈駅	宮城県
大越駅	福島県
大崎駅	東京都
大沢駅	山形県	新潟県
大蛇駅	青森県
大白川駅	新潟県
大平駅	青森県
大滝駅	山形県
大滝温泉駅	秋田県
大館駅	秋田県
太田部駅	長野県
大塚駅	東京都
大月駅	山梨県
大津港駅	茨城県
大戸駅	千葉県
大戸瀬駅	青森県
大貫駅	千葉県
大野駅	福島県
大原駅	千葉県
大張野駅	秋田県
大平下駅	栃木県
大更駅	岩手県
大船駅	神奈川県
大堀駅	山形県
大前駅	群馬県
大曲駅	秋田県
大間越駅	青森県
大甕駅	茨城県
大湊駅	青森県
大宮駅	埼玉県
大森駅	東京都
大鰐温泉駅	青森県
男鹿駅	秋田県
御徒町駅	東京都
岡部駅	埼玉県
岡本駅	栃木県
岡谷駅	長野県
小川郷駅	福島県
小川町駅	埼玉県
荻川駅	新潟県
荻窪駅	東京都
小木津駅	茨城県
翁島駅	福島県
荻野駅	福島県
小木ノ城駅	新潟県
尾久駅	東京都
奥多摩駅	東京都
奥内駅	青森県
小国駅	山形県
奥新川駅	宮城県
桶川駅	埼玉県
越生駅	埼玉県
小作駅	東京都
小塩江駅	福島県
押切駅	新潟県
小島谷駅	新潟県
小高駅	福島県
小田栄駅	神奈川県
小田林駅	茨城県
小田原駅	神奈川県	神奈川県
小千谷駅	新潟県
御茶ノ水駅	東京都
乙女駅	長野県
女川駅	宮城県
小野駅	長野県	滋賀県
小野上駅	群馬県
小野上温泉駅	群馬県
小野新町駅	福島県
尾登駅	福島県
姨捨駅	長野県
帯織駅	新潟県
小櫃駅	千葉県
小俣駅	栃木県
小見川駅	千葉県
思川駅	栃木県
面白山高原駅	山形県
小山駅	栃木県
小山田駅	岩手県
折壁駅	岩手県
折原駅	埼玉県
折渡駅	秋田県
御宿駅	千葉県
ガーラ湯沢駅	新潟県
甲斐大泉駅	山梨県
甲斐小泉駅	山梨県
海瀬駅	長野県
貝田駅	福島県
海浜幕張駅	千葉県
甲斐大和駅	山梨県
偕楽園(臨)駅	茨城県
替佐駅	長野県
鏡石駅	福島県
香川駅	神奈川県
柿崎駅	新潟県
角館駅	秋田県
佳景山駅	宮城県
籠原駅	埼玉県
葛西臨海公園駅	東京都
笠島駅	新潟県
笠幡駅	埼玉県
笠間駅	茨城県
加治駅	新潟県
鹿島駅	福島県
鹿島サッカースタジアム駅	茨城県
鹿島神宮駅	茨城県
鹿島田駅	神奈川県
鹿島台駅	宮城県
柏駅	千葉県
柏木平駅	岩手県
柏崎駅	新潟県
春日居町駅	山梨県
上総一ノ宮駅	千葉県
上総興津駅	千葉県
上総亀山駅	千葉県
上総清川駅	千葉県
上総松丘駅	千葉県
上総湊駅	千葉県
風合瀬駅	青森県
片岡駅	栃木県
片倉駅	東京都
潟町駅	新潟県
勝浦駅	千葉県
勝木駅	新潟県
勝田駅	茨城県
勝沼ぶどう郷駅	山梨県
鹿角花輪駅	秋田県
鹿妻駅	宮城県
桂根駅	秋田県
鹿渡駅	秋田県
門沢橋駅	神奈川県
角の浜駅	岩手県
香取駅	千葉県
金島駅	群馬県
金塚駅	新潟県
金町駅	東京都
要田駅	福島県
金谷川駅	福島県
金谷沢駅	青森県
蟹田駅	青森県
鹿沼駅	栃木県
金ケ崎駅	岩手県
金子駅	埼玉県
金浜駅	青森県
鹿瀬駅	新潟県
鹿又駅	宮城県
河辺駅	東京都
釜石駅	岩手県
鎌倉駅	神奈川県
蒲須坂駅	栃木県
蒲田駅	東京都
鎌取駅	千葉県
釜淵駅	山形県
上有住駅	岩手県
上飯島駅	秋田県
上今井駅	長野県
上小川駅	茨城県
上桑名川駅	長野県
上境駅	長野県
上条駅	新潟県
神城駅	長野県
上菅谷駅	茨城県
上諏訪駅	長野県
上所駅	新潟県
上中里駅	東京都
上野尻駅	福島県
上野目駅	宮城県
かみのやま温泉駅	山形県
上浜駅	秋田県
上二田駅	秋田県
上溝駅	神奈川県
上牧駅	群馬県
上盛岡駅	岩手県
神山駅	新潟県
上湯沢駅	秋田県
上米内駅	岩手県
上涌谷駅	宮城県
冠着駅	長野県
亀有駅	東京都
亀戸駅	東京都
亀田駅	新潟県
加茂駅	新潟県	京都府
鴨居駅	神奈川県
鴨宮駅	神奈川県
烏山駅	栃木県
狩川駅	山形県
刈羽駅	新潟県
刈和野駅	秋田県
軽井沢駅	長野県
河合駅	茨城県
川井駅	東京都
川内駅	岩手県	鹿児島県
川岸駅	長野県
川口駅	埼玉県
川桁駅	福島県
川越駅	埼玉県
川崎駅	神奈川県
川崎新町駅	神奈川県
川島駅	茨城県
川渡温泉駅	宮城県
川中島駅	長野県
川東駅	福島県
川部駅	青森県
川辺沖駅	福島県
川前駅	福島県
川原湯温泉駅	群馬県
神田駅	東京都
神立駅	茨城県
関内駅	神奈川県
神俣駅	福島県
木下駅	千葉県
祇園駅	千葉県
喜久田駅	福島県
菊名駅	神奈川県
象潟駅	秋田県
木更津駅	千葉県
北赤羽駅	東京都
北上尾駅	埼玉県
北朝霞駅	埼玉県
北余目駅	山形県
北飯山駅	長野県
北浦駅	宮城県
北浦和駅	埼玉県
北大石田駅	山形県
北大曲駅	秋田県
北大町駅	長野県
北柏駅	千葉県
喜多方駅	福島県
北金岡駅	秋田県
北金ケ沢駅	青森県
北鎌倉駅	神奈川県
北上駅	岩手県
北鴻巣駅	埼玉県
北小金駅	千葉県
北五泉駅	新潟県
北三条駅	新潟県
北条駅	新潟県
北白川駅	宮城県
北千住駅	東京都
北仙台駅	宮城県
北高崎駅	群馬県
北茅ケ崎駅	神奈川県
北常盤駅	青森県
北戸田駅	埼玉県
北長岡駅	新潟県
北中込駅	長野県
北能代駅	秋田県
北野辺地駅	青森県
北八王子駅	東京都
北藤岡駅	群馬県
北府中駅	東京都
北細野駅	長野県
北堀之内駅	新潟県
北松戸駅	千葉県
北松本駅	長野県
北本駅	埼玉県
北森駅	岩手県
北山駅	宮城県
北山形駅	山形県
北吉田駅	新潟県
北与野駅	埼玉県
吉祥寺駅	東京都
木造駅	青森県
木戸駅	福島県
衣笠駅	神奈川県
来宮駅	静岡県
君津駅	千葉県
京ケ瀬駅	新潟県
行田駅	埼玉県
清川駅	山形県
清里駅	山梨県
桐原駅	新潟県
桐生駅	群馬県
錦糸町駅	東京都
空港第２ビル駅	千葉県
久喜駅	埼玉県
区界駅	岩手県
草野駅	福島県	兵庫県
久慈駅	岩手県
久地駅	神奈川県
鯨波駅	新潟県
葛岡駅	宮城県
久住駅	千葉県
久田野駅	福島県
国定駅	群馬県
国立駅	東京都
国見駅	宮城県
熊ケ根駅	宮城県
熊谷駅	埼玉県
熊川駅	東京都
求名駅	千葉県
倉賀野駅	群馬県
倉橋駅	千葉県
倉見駅	神奈川県
くりこま高原駅	宮城県
栗橋駅	埼玉県
久里浜駅	神奈川県
久留里駅	千葉県
黒井駅	新潟県	兵庫県
黒磯駅	栃木県
黒沢駅	秋田県
黒田原駅	栃木県
黒山駅	新潟県
桑川駅	新潟県
桑名川駅	長野県
群馬大津駅	群馬県
群馬総社駅	群馬県
群馬原町駅	群馬県
群馬藤岡駅	群馬県
群馬八幡駅	群馬県
猊鼻渓駅	岩手県
下条駅	新潟県
気仙沼駅	宮城県
下馬駅	宮城県
花原市駅	岩手県
検見川浜駅	千葉県
五井駅	千葉県
鯉川駅	秋田県
小出駅	新潟県
小岩駅	東京都
小岩井駅	岩手県
小岩川駅	山形県
高円寺駅	東京都
郷沢駅	青森県
国府津駅	神奈川県	神奈川県
郷戸駅	福島県
港南台駅	神奈川県
鴻巣駅	埼玉県
鴻野山駅	栃木県
郷原駅	群馬県
甲府駅	山梨県	山梨県
好摩駅	岩手県
小海駅	長野県
桑折駅	福島県
郡山駅	福島県	奈良県
郡山富田駅	福島県
古河駅	茨城県
小金井駅	栃木県
後閑駅	群馬県
国道駅	神奈川県
国府多賀城駅	宮城県
国分寺駅	東京都
小牛田駅	宮城県
九重駅	千葉県
小砂川駅	秋田県
小佐野駅	岩手県
後三年駅	秋田県
越谷レイクタウン駅	埼玉県
越水駅	青森県
五所川原駅	青森県
越河駅	宮城県
五泉駅	新潟県
後台駅	茨城県
児玉駅	埼玉県
五反田駅	東京都
小机駅	神奈川県
小鶴新田駅	宮城県
小中野駅	青森県
小梨駅	岩手県
金浦駅	秋田県
小波渡駅	山形県
小塙駅	栃木県
小林駅	千葉県	宮崎県
小針駅	新潟県
五百川駅	福島県
古淵駅	神奈川県
小淵沢駅	山梨県
湖北駅	千葉県
駒形駅	群馬県
駒ケ嶺駅	福島県
高麗川駅	埼玉県
駒込駅	東京都
小松川駅	秋田県
小宮駅	東京都
小諸駅	長野県
小屋の畑駅	岩手県
古里駅	東京都
犀潟駅	新潟県
西金駅	茨城県
さいたま新都心駅	埼玉県
蔵王駅	山形県
堺田駅	山形県
寒河江駅	山形県
酒折駅	山梨県
坂北駅	長野県
酒田駅	山形県
坂町駅	新潟県
相模湖駅	神奈川県
相模原駅	神奈川県
坂元駅	宮城県
咲花駅	新潟県
佐久海ノ口駅	長野県
佐久平駅	長野県
作並駅	宮城県
佐久広瀬駅	長野県
佐倉駅	千葉県
桜木町駅	神奈川県
さくらんぼ東根駅	山形県
砂越駅	山形県
笹川駅	千葉県
佐々木駅	新潟県
笹木野駅	福島県
笹子駅	山梨県
指扇駅	埼玉県
刺巻駅	秋田県
さつき野駅	新潟県
里白石駅	福島県
佐貫町駅	千葉県
佐野駅	栃木県
寒川駅	神奈川県
侍浜駅	岩手県
鮫駅	青森県
猿田駅	千葉県
猿橋駅	山梨県
猿和田駅	新潟県
佐和駅	茨城県
沢井駅	東京都
沢尻駅	秋田県
沢田駅	宮城県
沢目駅	秋田県
佐原駅	千葉県
三条駅	新潟県
三瀬駅	山形県
椎柴駅	千葉県
Jヴィレッジ駅	福島県
塩釜駅	宮城県
塩川駅	福島県
塩崎駅	山梨県
塩沢駅	新潟県
塩尻駅	長野県	長野県
四方津駅	山梨県
潮見駅	東京都
敷島駅	群馬県
宍戸駅	茨城県
静駅	茨城県
酒々井駅	千葉県
雫石駅	岩手県
自治医大駅	栃木県
七戸十和田駅	青森県
尻手駅	神奈川県
品井沼駅	宮城県
品川駅	東京都	東京都
信濃浅野駅	長野県
信濃大町駅	長野県
信濃川上駅	長野県
信濃川島駅	長野県
信濃木崎駅	長野県
信濃境駅	長野県
信濃白鳥駅	長野県
信濃平駅	長野県
信濃常盤駅	長野県
信濃町駅	東京都
信濃松川駅	長野県
信濃森上駅	長野県
篠ノ井駅	長野県
柴宿駅	岩手県
新発田駅	新潟県
柴橋駅	山形県
柴平駅	秋田県
渋川駅	群馬県
渋谷駅	東京都
島内駅	長野県
島高松駅	長野県
清水原駅	岩手県
下総神崎駅	千葉県
下総橘駅	千葉県
下総豊里駅	千葉県
下総中山駅	千葉県
下総松崎駅	千葉県
下小川駅	茨城県
下川沿駅	秋田県
下北駅	青森県
下郡駅	千葉県
下菅谷駅	茨城県
下諏訪駅	長野県
下館駅	茨城県
下野大沢駅	栃木県
下野花岡駅	栃木県
下野宮駅	茨城県
下浜駅	秋田県
下溝駅	神奈川県
下湯沢駅	秋田県
社家駅	神奈川県
十王駅	茨城県
十条駅	東京都
十二橋駅	千葉県
十二湖駅	青森県
十二所駅	秋田県
十文字駅	秋田県
宿河原駅	神奈川県
宿戸駅	岩手県
上越国際スキー場前駅	新潟県
上越妙高駅	新潟県	新潟県
上下浜駅	新潟県
上戸駅	福島県
生田駅	秋田県
上毛高原駅	群馬県
昭和駅	神奈川県
白岡駅	埼玉県
白神岳登山口駅	青森県
白河駅	福島県
白坂駅	福島県
白沢駅	秋田県	鹿児島県
白石蔵王駅	宮城県
白銀駅	青森県
白丸駅	東京都
紫波中央駅	岩手県
新秋津駅	東京都
新浦安駅	千葉県
新大久保駅	東京都
新川崎駅	神奈川県
新木場駅	東京都
神宮寺駅	秋田県
新検見川駅	千葉県
新小岩駅	東京都
新小平駅	東京都
新子安駅	神奈川県
新芝浦駅	神奈川県
新宿駅	東京都
新庄駅	山形県
新白岡駅	埼玉県
新白河駅	福島県
新杉田駅	神奈川県
新関駅	新潟県
神代駅	秋田県	山口県
新地駅	福島県
新習志野駅	千葉県
新日本橋駅	東京都
陣場駅	秋田県
新橋駅	東京都
新花巻駅	岩手県
新府駅	山梨県
神保原駅	埼玉県
新前橋駅	群馬県
新町駅	群馬県
神町駅	山形県
新松戸駅	千葉県
新三郷駅	埼玉県
新茂原駅	千葉県
新八柱駅	千葉県
新横浜駅	神奈川県	神奈川県
新利府駅	宮城県
水郷駅	千葉県
水道橋駅	東京都
水原駅	新潟県
末続駅	福島県
末広駅	秋田県
須賀川駅	福島県
巣鴨駅	東京都
菅谷駅	福島県
杉田駅	福島県
逗子駅	神奈川県
雀宮駅	栃木県
すずらんの里駅	長野県
摺沢駅	岩手県
関都駅	福島県
関根駅	山形県
関屋駅	新潟県
瀬辺地駅	青森県
瀬見温泉駅	山形県
瀬峰駅	宮城県
千畳敷駅	青森県
仙台駅	宮城県
千駄ケ谷駅	東京都
千徳駅	岩手県
仙北町駅	岩手県
千厩駅	岩手県
相武台下駅	神奈川県
相馬駅	福島県
蘇我駅	千葉県
袖ケ浦駅	千葉県
袖崎駅	山形県
曽波神駅	宮城県
醍醐駅	秋田県
太子堂駅	宮城県
大釈迦駅	青森県
太東駅	千葉県
平館駅	岩手県
田浦駅	神奈川県
高岩駅	長野県
高尾駅	東京都
高城町駅	宮城県
高久駅	栃木県
高崎駅	群馬県
高崎問屋町駅	群馬県
多賀城駅	宮城県
高瀬駅	山形県	香川県
高田馬場駅	東京都
高擶駅	山形県
高輪ゲートウェイ駅	東京都
鷹ノ巣駅	秋田県
高萩駅	茨城県
高畠駅	山形県
高浜駅	茨城県
田上駅	新潟県
高屋駅	山形県
滝駅	栃木県	兵庫県
滝ノ間駅	秋田県
滝谷駅	福島県
竹岡駅	千葉県
竹沢駅	埼玉県
田沢駅	長野県
田沢湖駅	秋田県
田尻駅	宮城県
只見駅	福島県
立川駅	東京都
立小路駅	山形県
龍岡城駅	長野県
竜田駅	福島県
辰野駅	長野県	長野県
伊達駅	福島県
立ケ花駅	長野県
立川目駅	岩手県
館腰駅	宮城県
館山駅	千葉県
楯山駅	山形県
種市駅	岩手県
種差海岸駅	青森県
田端駅	東京都
玉川駅	岩手県
玉川村駅	茨城県
田町駅	東京都
玉戸駅	茨城県
田山駅	岩手県
俵田駅	千葉県
丹荘駅	埼玉県
近川駅	青森県
茅ケ崎駅	神奈川県
近津駅	福島県
千国駅	長野県
千倉駅	千葉県
茅野駅	長野県
千葉駅	千葉県
千葉みなと駅	千葉県
中郡駅	山形県
銚子駅	千葉県
長者町駅	千葉県
都賀駅	千葉県
塚目駅	宮城県
塚山駅	新潟県
津軽新城駅	青森県
津軽浜名駅	青森県
津軽二股駅	青森県
津軽宮田駅	青森県
津軽湯の沢駅	青森県
津川駅	新潟県
月岡駅	新潟県
槻木駅	宮城県
津久田駅	群馬県
辻堂駅	神奈川県
津田沼駅	千葉県
津田山駅	神奈川県
土浦駅	茨城県
土崎駅	秋田県
土沢駅	岩手県
土樽駅	新潟県
榴ケ岡駅	宮城県
津南駅	新潟県
燕駅	新潟県
燕三条駅	新潟県
津谷駅	山形県
鶴岡駅	山形県
鶴ケ坂駅	青森県
鶴形駅	秋田県
鶴田駅	栃木県
鶴泊駅	青森県
鶴見駅	神奈川県
鶴見小野駅	神奈川県
手樽駅	宮城県
出戸浜駅	秋田県
手ノ子駅	山形県
寺尾駅	新潟県
寺泊駅	新潟県
天童駅	山形県
天童南駅	山形県
天王駅	秋田県
天王台駅	千葉県
土合駅	群馬県
土市駅	新潟県
東海駅	茨城県
東金駅	千葉県
東京駅	東京都	東京都
峠駅	山形県
東光寺駅	新潟県
堂島駅	福島県
東照宮駅	宮城県
洞泉駅	岩手県
塔寺駅	福島県
東名駅	宮城県
東北福祉大前駅	宮城県
十日市場駅	神奈川県
十日町駅	新潟県
遠野駅	岩手県
戸狩野沢温泉駅	長野県
徳沢駅	福島県
土気駅	千葉県
土底浜駅	新潟県
戸田駅	埼玉県	山口県
戸田公園駅	埼玉県
栃木駅	栃木県
戸塚駅	神奈川県
驫木駅	青森県
土深井駅	秋田県
富岡駅	福島県
富田駅	栃木県	三重県
富根駅	秋田県
友部駅	茨城県
豊栄駅	新潟県
豊科駅	長野県
豊田駅	東京都
豊野駅	長野県
豊原駅	栃木県
豊実駅	新潟県
東浪見駅	千葉県
鳥形駅	秋田県
鳥沢駅	山梨県
取手駅	茨城県
土呂駅	埼玉県
十和田南駅	秋田県
撫牛子駅	青森県
直江津駅	新潟県
中浦駅	新潟県
長浦駅	千葉県
中浦和駅	埼玉県
長岡駅	新潟県
中神駅	東京都
中萱駅	長野県
中川駅	山形県
中込駅	長野県
長坂駅	山梨県
中佐都駅	長野県
中沢駅	青森県
長沢駅	山形県
中条駅	新潟県
中菅谷駅	茨城県
中田駅	青森県	徳島県
永田駅	千葉県
長津田駅	神奈川県
中豊駅	福島県
長鳥駅	新潟県
長苗代駅	青森県
中野駅	東京都
長野駅	長野県
中野栄駅	宮城県
中野島駅	神奈川県
中之条駅	群馬県
長野原草津口駅	群馬県
中舟生駅	茨城県
長町駅	宮城県
長峰駅	青森県
中山駅	神奈川県
中山宿駅	福島県
中山平温泉駅	宮城県
勿来駅	福島県
那古船形駅	千葉県
那須塩原駅	栃木県
夏井駅	福島県
名取駅	宮城県
七日町駅	福島県
浪江駅	福島県
浪岡駅	青森県
浪花駅	千葉県
滑河駅	千葉県
行川アイランド駅	千葉県
滑津駅	長野県
成田駅	千葉県
成田空港駅	千葉県
鳴子温泉駅	宮城県
鳴子御殿湯駅	宮城県
鳴沢駅	青森県
成島駅	山形県
成瀬駅	東京都
成東駅	千葉県
新潟駅	新潟県
新潟大学前駅	新潟県
新座駅	埼玉県
新崎駅	新潟県
仁井田駅	栃木県	高知県
新津駅	新潟県
新月駅	岩手県
新鶴駅	福島県
新治駅	茨城県
苦竹駅	宮城県
仁賀保駅	秋田県
西浦和駅	埼玉県
西大井駅	東京都
西大崎駅	宮城県
西大滝駅	長野県
西大宮駅	埼玉県
西荻窪駅	東京都
西川口駅	埼玉県
西川越駅	埼玉県
西国立駅	東京都
西国分寺駅	東京都
西寒河江駅	山形県
西塩釜駅	宮城県
西新発田駅	新潟県
西条駅	長野県	広島県
西立川駅	東京都
西千葉駅	千葉県
西燕駅	新潟県
西中通駅	新潟県
西那須野駅	栃木県
西日暮里駅	東京都
西八王子駅	東京都
西府駅	東京都
西袋駅	山形県
西船橋駅	千葉県
西古川駅	宮城県
西松井田駅	群馬県
西目駅	秋田県
西山駅	新潟県
西米沢駅	山形県
西若松駅	福島県
似内駅	岩手県
日光駅	栃木県
新田駅	宮城県	京都府
日立木駅	福島県
日暮里駅	東京都
二戸駅	岩手県
二宮駅	神奈川県
二本松駅	福島県
韮崎駅	山梨県
庭坂駅	福島県
糠沢駅	秋田県
額田駅	茨城県
沼田駅	群馬県
根岸駅	神奈川県	福島県
鼠ケ関駅	山形県
根府川駅	神奈川県
野上原駅	茨城県
野木駅	栃木県
野木沢駅	福島県
野崎駅	栃木県	大阪府
野沢駅	福島県
能代駅	秋田県
及位駅	山形県
のの岳駅	宮城県
野蒜駅	宮城県
延方駅	茨城県
野辺地駅	青森県
野辺山駅	長野県
登戸駅	神奈川県
拝島駅	東京都
萩生駅	山形県
白山駅	新潟県
白馬駅	長野県
白馬大池駅	長野県
柏矢町駅	長野県
羽黒駅	茨城県
羽黒下駅	長野県
馬喰町駅	東京都
箱石駅	岩手県
箱根ケ崎駅	東京都
羽沢横浜国大駅	神奈川県
階上駅	青森県
橋本駅	神奈川県	和歌山県
蓮田駅	埼玉県
羽立駅	秋田県
八王子駅	東京都
八王子みなみ野駅	東京都
蓮駅	長野県
八戸駅	青森県
八幡平駅	秋田県
八森駅	秋田県
八郎潟駅	秋田県
初狩駅	山梨県
八丁畷駅	神奈川県
八丁堀駅	東京都
鳩ノ巣駅	東京都
羽鳥駅	茨城県
花泉駅	岩手県
花巻駅	岩手県
花巻空港駅	岩手県
羽生田駅	新潟県
羽根尾駅	群馬県
浜金谷駅	千葉県
浜川崎駅	神奈川県
浜野駅	千葉県
浜松町駅	東京都
浜吉田駅	宮城県
羽村駅	東京都
早川駅	神奈川県
早口駅	秋田県
林崎駅	青森県
早戸駅	福島県
早通駅	新潟県
原宿駅	東京都
腹帯駅	岩手県
原当麻駅	神奈川県
原ノ町駅	福島県
春木場駅	岩手県
晴山駅	岩手県
番田駅	神奈川県
磐梯熱海駅	福島県
磐梯町駅	福島県
東秋留駅	東京都
東我孫子駅	千葉県
東浦和駅	埼玉県
東青梅駅	東京都
東大崎駅	宮城県
東大館駅	秋田県
東大更駅	岩手県
東大宮駅	埼玉県
東柏崎駅	新潟県
東金井駅	山形県
東神奈川駅	神奈川県
東川口駅	埼玉県
東清川駅	千葉県
東下条駅	新潟県
東小金井駅	東京都
東小諸駅	長野県
東酒田駅	山形県
東三条駅	新潟県
東塩釜駅	宮城県
東十条駅	東京都
東白石駅	宮城県
東逗子駅	神奈川県
東仙台駅	宮城県
東館駅	福島県
東千葉駅	千葉県
東所沢駅	埼玉県
東戸塚駅	神奈川県
東中神駅	東京都
東長沢駅	山形県
東中野駅	東京都
東長原駅	福島県
東新潟駅	新潟県
東新津駅	新潟県
東根駅	山形県
東能代駅	秋田県
東八森駅	秋田県
東飯能駅	埼玉県
東福島駅	福島県
東福生駅	東京都
東船橋駅	千葉県
東松戸駅	千葉県
東山梨駅	山梨県
東矢本駅	宮城県
東結城駅	茨城県
東横田駅	千葉県
東鷲宮駅	埼玉県
干潟駅	千葉県
蟇目駅	岩手県
久ノ浜駅	福島県
聖高原駅	長野県
日立駅	茨城県
常陸青柳駅	茨城県
常陸太田駅	茨城県
常陸大宮駅	茨城県
常陸鴻巣駅	茨城県
常陸大子駅	茨城県
常陸多賀駅	茨城県
常陸津田駅	茨城県
ひたち野うしく駅	茨城県
左堰駅	青森県
日詰駅	岩手県
日出谷駅	新潟県
一日市場駅	長野県
日向和田駅	東京都
日野駅	東京都
日野春駅	山梨県
日向駅	千葉県
平井駅	東京都
平泉駅	岩手県
平木田駅	新潟県
平倉駅	岩手県
平田駅	長野県
平滝駅	長野県
平塚駅	神奈川県
平内駅	岩手県
平林駅	新潟県
平間駅	神奈川県
平山駅	千葉県
広丘駅	長野県
弘前駅	青森県
広田駅	福島県
広戸駅	青森県
広野駅	福島県	兵庫県
日和田駅	福島県
深浦駅	青森県
深谷駅	埼玉県
吹上駅	埼玉県
福島駅	福島県	大阪府
福田町駅	宮城県
福俵駅	千葉県
福原駅	茨城県
吹浦駅	山形県
袋倉駅	群馬県
袋田駅	茨城県
布佐駅	千葉県
藤崎駅	青森県
藤沢駅	神奈川県
藤島駅	山形県
藤代駅	茨城県
藤田駅	福島県
藤根駅	岩手県
藤野駅	神奈川県
富士見駅	長野県
二田駅	秋田県
二ツ井駅	秋田県
双葉駅	福島県
二俣尾駅	東京都
二俣新町駅	千葉県
淵野辺駅	神奈川県
府中本町駅	東京都
吹越駅	青森県
福生駅	東京都
太海駅	千葉県
船岡駅	宮城県	京都府
舟形駅	山形県
船越駅	秋田県
船橋駅	千葉県
船橋法典駅	千葉県
船引駅	福島県
分倍河原駅	東京都
文挟駅	栃木県
府屋駅	新潟県
古川駅	宮城県
古口駅	山形県
古館駅	岩手県
古津駅	新潟県
分水駅	新潟県
艫作駅	青森県
蛇田駅	宮城県
弁天橋駅	神奈川県
宝積寺駅	栃木県
細野駅	長野県
保田駅	千葉県
穂高駅	長野県
ほっとゆだ駅	岩手県
保土ケ谷駅	神奈川県
保内駅	新潟県
本郷台駅	神奈川県
本塩釜駅	宮城県
本庄駅	埼玉県
本庄早稲田駅	埼玉県
誉田駅	千葉県
本千葉駅	千葉県
本名駅	福島県
本納駅	千葉県
本八戸駅	青森県
舞浜駅	千葉県
前潟駅	岩手県
前川駅	新潟県
前沢駅	岩手県
前橋駅	群馬県
前橋大島駅	群馬県
前谷地駅	宮城県
前山駅	秋田県
馬下駅	新潟県
巻駅	新潟県
馬来田駅	千葉県
幕張駅	千葉県
幕張豊砂駅	千葉県
幕張本郷駅	千葉県
間島駅	新潟県
升形駅	山形県
鱒沢駅	岩手県
真滝駅	岩手県
町田駅	東京都
松井田駅	群馬県
松尾駅	千葉県
松尾八幡平駅	岩手県
松神駅	青森県
松川駅	福島県
松岸駅	千葉県
松草駅	岩手県
松倉駅	岩手県
松島駅	宮城県
松島海岸駅	宮城県
松戸駅	千葉県
松原湖駅	長野県
松久駅	埼玉県
松本駅	長野県
松山町駅	宮城県
的場駅	埼玉県
馬流駅	長野県
真鶴駅	神奈川県
馬橋駅	千葉県
間々田駅	栃木県
真室川駅	山形県
万石浦駅	宮城県
万座・鹿沢口駅	群馬県
三門駅	千葉県
三河島駅	東京都
三郷駅	埼玉県	奈良県
美里駅	長野県
水沢駅	岩手県
水沢江刺駅	岩手県
三鷹駅	東京都
御嶽駅	東京都
御岳堂駅	宮城県
乱川駅	山形県
道川駅	秋田県
三岡駅	長野県
見附駅	新潟県
三関駅	秋田県
水戸駅	茨城県
みどり湖駅	長野県
水上駅	群馬県
南石井駅	福島県
南浦和駅	埼玉県
南大町駅	長野県
南小谷駅	長野県	長野県
南柏駅	千葉県
南神城駅	長野県
南越谷駅	埼玉県
南酒出駅	茨城県
南寒河江駅	山形県
南酒々井駅	千葉県
南新庄駅	山形県
南千住駅	東京都
南仙台駅	宮城県
南多摩駅	東京都
南鳥海駅	山形県
南出羽駅	山形県
南豊科駅	長野県
南中郷駅	茨城県
南流山駅	千葉県
南野駅	山形県
南橋本駅	神奈川県
南三原駅	千葉県
南福島駅	福島県
南船橋駅	千葉県
南古谷駅	埼玉県
南松本駅	長野県
南吉田駅	新潟県
南米沢駅	山形県
南与野駅	埼玉県
峰吉川駅	秋田県
三春駅	福島県
宮内駅	新潟県
宮城野原駅	宮城県
宮古駅	岩手県
宮ノ平駅	東京都
宮原駅	埼玉県
宮守駅	岩手県
宮山駅	神奈川県
明覚駅	埼玉県
妙法寺駅	新潟県
三厩駅	青森県
六日町駅	新潟県
向河原駅	神奈川県
向能代駅	秋田県
武蔵五日市駅	東京都
武蔵浦和駅	埼玉県
武蔵小金井駅	東京都
武蔵小杉駅	神奈川県
武蔵境駅	東京都
武蔵白石駅	神奈川県
武蔵新城駅	神奈川県
武蔵高萩駅	埼玉県
武蔵中原駅	神奈川県
武蔵引田駅	東京都
武蔵増戸駅	東京都
武蔵溝ノ口駅	神奈川県
陸奥赤石駅	青森県
陸奥岩崎駅	青森県
陸奥沢辺駅	青森県
陸奥白浜駅	青森県
陸奥鶴田駅	青森県
陸奥湊駅	青森県
陸奥森田駅	青森県
陸奥柳田駅	青森県
陸奥横浜駅	青森県
村井駅	長野県
村上駅	新潟県
村崎野駅	岩手県
村山駅	山形県
女鹿駅	山形県
目黒駅	東京都
目白駅	東京都
茂市駅	岩手県
舞木駅	福島県
最上駅	山形県
茂吉記念館前駅	山形県
本楯駅	山形県
本宮駅	福島県
本八幡駅	千葉県
物井駅	千葉県
茂原駅	千葉県
桃内駅	福島県
盛岡駅	岩手県
森岳駅	秋田県
森宮野原駅	長野県
毛呂駅	埼玉県
矢板駅	栃木県
八色駅	新潟県
矢川駅	東京都
谷河原駅	茨城県
八木原駅	群馬県
矢倉駅	群馬県
矢向駅	神奈川県
矢越駅	岩手県
矢代田駅	新潟県
安田駅	新潟県
谷田川駅	福島県
八千穂駅	長野県
八街駅	千葉県
八積駅	千葉県
柳津駅	宮城県
梁川駅	山梨県
柳田駅	秋田県
柳原駅	岩手県	愛媛県
簗場駅	長野県
矢野口駅	東京都
矢作駅	新潟県
矢幅駅	岩手県
弥彦駅	新潟県
藪神駅	新潟県
矢吹駅	福島県
矢部駅	神奈川県
谷保駅	東京都
山形駅	山形県
山方宿駅	茨城県
山岸駅	岩手県
山下駅	宮城県
矢祭山駅	福島県
山手駅	神奈川県
山寺駅	山形県
山都駅	福島県
大和駅	茨城県
山梨市駅	山梨県
山ノ目駅	岩手県
山前駅	栃木県
矢本駅	宮城県
鑓見内駅	秋田県
八幡宿駅	千葉県
結城駅	茨城県
有備館駅	宮城県
有楽町駅	東京都
湯河原駅	神奈川県
遊佐駅	山形県
湯沢駅	秋田県
油島駅	岩手県
湯瀬温泉駅	秋田県
ゆだ錦秋湖駅	岩手県
ゆだ高原駅	岩手県
湯檜曽駅	群馬県
湯本駅	福島県
八日市場駅	千葉県
洋光台駅	神奈川県
用土駅	埼玉県
横磯駅	青森県
横川駅	群馬県	広島県
横川目駅	岩手県
横倉駅	長野県
横芝駅	千葉県
横須賀駅	神奈川県
横田駅	千葉県
横手駅	秋田県
横浜駅	神奈川県
横堀駅	秋田県
横間駅	岩手県
吉川駅	埼玉県
吉川美南駅	埼玉県
吉田駅	新潟県
四街道駅	千葉県
四ツ倉駅	福島県
四ツ小屋駅	秋田県
四ツ谷駅	東京都
米沢駅	山形県
米山駅	新潟県
与野駅	埼玉県
与野本町駅	埼玉県
夜ノ森駅	福島県
蓬田駅	青森県
代々木駅	東京都
寄居駅	埼玉県
来迎寺駅	新潟県
礼拝駅	新潟県
陸前赤井駅	宮城県
陸前稲井駅	宮城県
陸前大塚駅	宮城県
陸前落合駅	宮城県
陸前小野駅	宮城県
陸前山王駅	宮城県
陸前白沢駅	宮城県
陸前高砂駅	宮城県
陸前富山駅	宮城県
陸前豊里駅	宮城県
陸前浜田駅	宮城県
陸前原ノ町駅	宮城県
陸前谷地駅	宮城県
陸前山下駅	宮城県
陸中大里駅	秋田県
陸中大橋駅	岩手県
陸中折居駅	岩手県
陸中川井駅	岩手県
陸中門崎駅	岩手県
陸中中野駅	岩手県
陸中夏井駅	岩手県
陸中松川駅	岩手県
陸中八木駅	岩手県
利府駅	宮城県
竜王駅	山梨県
龍ケ崎市駅	茨城県
両国駅	東京都
六原駅	岩手県
和賀仙人駅	岩手県
若宮駅	福島県
脇本駅	秋田県
涌谷駅	宮城県
和田駅	秋田県
和田浦駅	千葉県
渡波駅	宮城県
亘理駅	宮城県
和渕駅	宮城県
蕨駅	埼玉県
相賀駅	三重県
愛知御津駅	愛知県
相月駅	静岡県
逢妻駅	愛知県
愛野駅	静岡県
相見駅	愛知県
赤木駅	長野県
上松駅	長野県
阿漕駅	三重県
朝日駅	三重県
足柄駅	静岡県
芦川駅	山梨県
阿曽駅	三重県
新鹿駅	三重県
阿田和駅	三重県
熱田駅	愛知県
安倍川駅	静岡県
新居町駅	静岡県
荒尾駅	岐阜県	熊本県
有井駅	三重県
安城駅	愛知県
飯島駅	長野県
飯田駅	長野県
家城駅	三重県
池場駅	愛知県
石浜駅	愛知県
一身田駅	三重県
五十鈴ケ丘駅	三重県
出馬駅	静岡県
伊勢大井駅	三重県
伊勢奥津駅	三重県
伊勢柏崎駅	三重県
伊勢鎌倉駅	三重県
伊勢川口駅	三重県
井関駅	三重県
伊勢市駅	三重県
伊勢竹原駅	三重県
伊勢八太駅	三重県
伊勢八知駅	三重県
井田川駅	三重県
市川大門駅	山梨県
市川本町駅	山梨県
一志駅	三重県
市田駅	長野県
市ノ瀬駅	山梨県
井出駅	山梨県
伊那大島駅	長野県
伊那上郷駅	長野県
伊那北駅	長野県
稲子駅	静岡県
伊那小沢駅	長野県
稲沢駅	愛知県
伊那市駅	長野県
伊那新町駅	長野県
伊那田島駅	長野県
伊那福岡駅	長野県
伊那本郷駅	長野県
伊那松島駅	長野県
伊那八幡駅	長野県
猪谷駅	富山県	富山県
入山瀬駅	静岡県
磐田駅	静岡県
岩波駅	静岡県
鶯巣駅	長野県
牛久保駅	愛知県
内船駅	山梨県
打保駅	岐阜県
鵜殿駅	三重県
鵜沼駅	岐阜県
梅ケ谷駅	三重県
浦川駅	静岡県
永和駅	愛知県
江島駅	愛知県
恵那駅	岐阜県
相可駅	三重県
近江長岡駅	滋賀県
大内山駅	三重県
大岡駅	静岡県
大垣駅	岐阜県
大桑駅	長野県
大曽根駅	愛知県
大曽根浦駅	三重県
大嵐駅	静岡県
大高駅	愛知県
大田切駅	長野県
大泊駅	三重県
大府駅	愛知県
大海駅	愛知県
岡崎駅	愛知県
緒川駅	愛知県
興津駅	静岡県
落合川駅	岐阜県
落居駅	山梨県
乙川駅	愛知県
尾頭橋駅	愛知県
尾鷲駅	三重県
尾張一宮駅	愛知県
尾張森岡駅	愛知県
甲斐岩間駅	山梨県
甲斐上野駅	山梨県
甲斐大島駅	山梨県
甲斐住吉駅	山梨県
甲斐常葉駅	山梨県
各務ケ原駅	岐阜県
柿平駅	愛知県
掛川駅	静岡県
笠寺駅	愛知県
加佐登駅	三重県
鰍沢口駅	山梨県
柏原駅	滋賀県	兵庫県	大阪府
春日井駅	愛知県
賀田駅	三重県
片浜駅	静岡県
勝川駅	愛知県
門島駅	長野県
鼎駅	長野県
金谷駅	静岡県
金山駅	愛知県
可児駅	岐阜県
蟹江駅	愛知県
金手駅	山梨県
蒲郡駅	愛知県
釜戸駅	岐阜県
上麻生駅	岐阜県
上市場駅	静岡県
上大井駅	神奈川県
上片桐駅	長野県
上ノ庄駅	三重県
亀崎駅	愛知県
亀山駅	三重県	三重県
唐笠駅	長野県
刈谷駅	愛知県
川路駅	長野県
川添駅	三重県
河曲駅	三重県
河原田駅	三重県
函南駅	静岡県
蒲原駅	静岡県
紀伊井田駅	三重県
紀伊市木駅	三重県
紀伊長島駅	三重県
菊川駅	静岡県
木曽川駅	愛知県
木曽平沢駅	長野県
木曽福島駅	長野県
北殿駅	長野県
木ノ下駅	長野県
岐阜駅	岐阜県
岐阜羽島駅	岐阜県
京都駅	京都府	京都府
共和駅	愛知県
清洲駅	愛知県
切石駅	長野県
金野駅	長野県
九鬼駅	三重県
久々野駅	岐阜県
草薙駅	静岡県
久那土駅	山梨県
熊野市駅	三重県
倉本駅	長野県
桑名駅	三重県
毛賀駅	長野県
下呂駅	岐阜県
源道寺駅	静岡県
小井川駅	山梨県
小泉駅	岐阜県
神志山駅	三重県
高蔵寺駅	愛知県
幸田駅	愛知県
国母駅	山梨県
古虎渓駅	岐阜県
小坂井駅	愛知県
御殿場駅	静岡県
古井駅	岐阜県
駒ケ根駅	長野県
小町屋駅	長野県
小和田駅	静岡県
権現前駅	三重県
坂上駅	岐阜県
坂下駅	岐阜県
坂祝駅	岐阜県
相模金子駅	神奈川県
佐久間駅	静岡県
桜町駅	長野県
佐奈駅	三重県
醒ケ井駅	滋賀県
沢駅	長野県
沢渡駅	長野県
三ケ根駅	愛知県
塩之沢駅	山梨県
静岡駅	静岡県
為栗駅	長野県
芝川駅	静岡県
島田駅	静岡県	山口県
清水駅	静岡県
下麻生駅	岐阜県
下市田駅	長野県
下川合駅	静岡県
下切駅	岐阜県
下地駅	愛知県
下島駅	長野県
下曽我駅	神奈川県
下平駅	長野県
下土狩駅	静岡県
下庄駅	三重県
下部温泉駅	山梨県
下山村駅	長野県
下油井駅	岐阜県
十二兼駅	長野県
常永駅	山梨県
定光寺駅	愛知県
上呂駅	岐阜県
白川口駅	岐阜県
城西駅	静岡県
新大阪駅	大阪府	大阪府
新蒲原駅	静岡県
新宮駅	和歌山県	和歌山県
新所原駅	静岡県
新城駅	愛知県
新守山駅	愛知県
神領駅	愛知県
杉崎駅	岐阜県
杉原駅	岐阜県
裾野駅	静岡県
須原駅	長野県
駿河小山駅	静岡県
関ケ原駅	岐阜県
関ノ宮駅	三重県
洗馬駅	長野県
善光寺駅	山梨県
禅昌寺駅	岐阜県
蘇原駅	岐阜県
高茶屋駅	三重県
高塚駅	静岡県
高遠原駅	長野県
高山駅	岐阜県
多気駅	三重県
滝原駅	三重県
田切駅	長野県
武豊駅	愛知県
武並駅	岐阜県
駄科駅	長野県
多治見駅	岐阜県
田立駅	長野県
竪堀駅	静岡県
田畑駅	長野県
田丸駅	三重県
田本駅	長野県
垂井駅	岐阜県
千種駅	愛知県
茶臼山駅	愛知県
中部天竜駅	静岡県
千代駅	長野県
津駅	三重県
角川駅	岐阜県
鶴舞駅	愛知県
天竜川駅	静岡県
天竜峡駅	長野県
東栄駅	愛知県
東上駅	愛知県
十島駅	山梨県
土岐市駅	岐阜県
外城田駅	三重県
時又駅	長野県
徳和駅	三重県
栃原駅	三重県
鳥羽駅	三重県
富田浜駅	三重県
豊川駅	愛知県
豊田町駅	静岡県
豊橋駅	愛知県
鳥居駅	愛知県
那加駅	岐阜県
中井侍駅	長野県
長泉なめり駅	静岡県
中川辺駅	岐阜県
長篠城駅	愛知県
長島駅	三重県
中津川駅	岐阜県
長森駅	岐阜県
長山駅	愛知県
渚駅	岐阜県
南木曽駅	長野県
名古屋駅	愛知県
七久保駅	長野県
奈良井駅	長野県
贄川駅	長野県
二木島駅	三重県
西岡崎駅	愛知県
西岐阜駅	岐阜県
西小坂井駅	愛知県
西富士宮駅	静岡県
西焼津駅	静岡県
温田駅	長野県
沼久保駅	静岡県
沼津駅	静岡県
根本駅	岐阜県
野尻駅	長野県
野田城駅	愛知県
野田新町駅	愛知県
波高島駅	山梨県
波田須駅	三重県
八田駅	愛知県
羽場駅	長野県
浜松駅	静岡県
早瀬駅	静岡県
原駅	静岡県
原野駅	長野県
春田駅	愛知県
半田駅	愛知県
東浦駅	愛知県
東刈谷駅	愛知県
東静岡駅	静岡県
東新町駅	愛知県
東田子の浦駅	静岡県
東成岩駅	愛知県
東花輪駅	山梨県
東山北駅	神奈川県
飛騨一ノ宮駅	岐阜県
飛騨小坂駅	岐阜県
飛騨金山駅	岐阜県
飛騨国府駅	岐阜県
飛騨萩原駅	岐阜県
飛騨古川駅	岐阜県
飛騨細江駅	岐阜県
飛騨宮田駅	岐阜県
比津駅	三重県
日出塩駅	長野県
姫駅	岐阜県
平岡駅	長野県
枇杷島駅	愛知県
袋井駅	静岡県
富士駅	静岡県
藤枝駅	静岡県
富士岡駅	静岡県
富士川駅	静岡県
富士根駅	静岡県
富士宮駅	静岡県
二川駅	愛知県
二見浦駅	三重県
船津駅	三重県
船町駅	愛知県
弁天島駅	静岡県
上枝駅	岐阜県
穂積駅	岐阜県
本長篠駅	愛知県
舞阪駅	静岡県
米原駅	滋賀県	滋賀県
松阪駅	三重県
松下駅	三重県
松田駅	神奈川県
三河安城駅	愛知県
三河一宮駅	愛知県
三河大塚駅	愛知県
三河大野駅	愛知県
三河川合駅	愛知県
三河塩津駅	愛知県
三河東郷駅	愛知県
三河槙原駅	愛知県
三河三谷駅	愛知県
三木里駅	三重県
御厨駅	静岡県
水窪駅	静岡県
三島駅	静岡県
瑞浪駅	岐阜県
三瀬谷駅	三重県
南大高駅	愛知県
南甲府駅	山梨県
南御殿場駅	静岡県
南四日市駅	三重県
美濃赤坂駅	岐阜県
美濃太田駅	岐阜県
美濃川合駅	岐阜県
美乃坂本駅	岐阜県
三野瀬駅	三重県
身延駅	山梨県
宮川駅	三重県
宮木駅	長野県
宮田駅	長野県
宮ノ越駅	長野県
向市場駅	静岡県
用宗駅	静岡県
元善光寺駅	長野県
焼津駅	静岡県
谷峨駅	神奈川県
焼石駅	岐阜県
弥富駅	愛知県
藪原駅	長野県
山北駅	神奈川県
山田上口駅	三重県
山吹駅	長野県
由比駅	静岡県
柚木駅	静岡県
湯谷温泉駅	愛知県
吉原駅	静岡県
四日市駅	三重県
寄畑駅	山梨県
六合駅	静岡県
六軒駅	三重県
鷲津駅	静岡県
相生駅	兵庫県
相野駅	兵庫県
藍本駅	兵庫県
粟生駅	兵庫県
青倉駅	兵庫県
青野ケ原駅	兵庫県
青郷駅	福井県
青野山駅	島根県
青原駅	島根県
青谷駅	鳥取県
赤碕駅	鳥取県
明石駅	兵庫県
英賀保駅	兵庫県
上道駅	鳥取県	岡山県
阿川駅	山口県
安芸阿賀駅	広島県
あき亀山駅	広島県
安芸川尻駅	広島県
安芸幸崎駅	広島県
安芸津駅	広島県
安芸長束駅	広島県
安芸中野駅	広島県
安芸長浜駅	広島県
安芸矢口駅	広島県
厚狭駅	山口県
浅香駅	大阪府
朝霧駅	兵庫県
浅利駅	島根県
安治川口駅	大阪府
阿知須駅	山口県
足立駅	岡山県
阿品駅	広島県
芦原橋駅	大阪府
足守駅	岡山県
芦屋駅	兵庫県
足羽駅	福井県
安栖里駅	京都府
厚保駅	山口県
朝来駅	和歌山県
安土駅	滋賀県
安登駅	広島県
安曇川駅	滋賀県
我孫子町駅	大阪府
油田駅	富山県
油日駅	滋賀県
網干駅	兵庫県
尼崎駅	兵庫県
甘地駅	兵庫県
雨晴駅	富山県
余子駅	鳥取県
餘部駅	兵庫県
綾部駅	京都府
綾羅木駅	山口県
荒島駅	島根県
粟野駅	福井県
芦原温泉駅	福井県
飯井駅	山口県
飯浦駅	島根県
伊賀上野駅	三重県
伊上駅	山口県
生野駅	兵庫県
生野屋駅	山口県
居組駅	兵庫県
井倉駅	岡山県
石原駅	京都府
石蟹駅	岡山県
石部駅	滋賀県
石山駅	滋賀県
和泉砂川駅	大阪府
和泉鳥取駅	大阪府
和泉橋本駅	大阪府
和泉府中駅	大阪府
出雲坂根駅	島根県
出雲市駅	島根県
出雲神西駅	島根県
出雲大東駅	島根県
出雲三成駅	島根県
出雲八代駅	島根県
出雲横田駅	島根県
石生駅	兵庫県
五十猛駅	島根県
伊丹駅	兵庫県
板持駅	山口県
市岡駅	岡山県
市島駅	兵庫県
一乗谷駅	福井県
市波駅	福井県
櫟本駅	奈良県
市場駅	兵庫県
五日市駅	広島県
糸魚川駅	新潟県
糸崎駅	広島県
稲枝駅	滋賀県
猪名寺駅	兵庫県
因幡社駅	鳥取県
稲原駅	和歌山県
印南駅	和歌山県
稲荷駅	京都府
居能駅	山口県
井原市駅	広島県
茨木駅	大阪府
今宮駅	大阪府
揖屋駅	島根県
伊里駅	岡山県
岩国駅	山口県
岩倉駅	山口県
岩代駅	和歌山県
岩田駅	山口県
岩出駅	和歌山県
岩鼻駅	山口県
岩美駅	鳥取県
石見津田駅	島根県
石見福光駅	島根県
石見横田駅	島根県
岩山駅	岡山県
院庄駅	岡山県
伊部駅	岡山県
上野芝駅	大阪府
植松駅	岡山県
魚住駅	兵庫県
鵜飼駅	広島県
宇賀本郷駅	山口県
宇久井駅	和歌山県
宇治駅	京都府
牛ケ原駅	福井県
太秦駅	京都府
宇田郷駅	山口県
打田駅	和歌山県
内名駅	広島県
有年駅	兵庫県
畝傍駅	奈良県
宇野駅	岡山県
宇野気駅	石川県
宇部駅	山口県
宇部新川駅	山口県
宇部岬駅	山口県
馬堀駅	京都府
梅ケ峠駅	山口県
梅小路京都西駅	京都府
梅迫駅	京都府
敬川駅	島根県
浦安駅	鳥取県
駅家駅	広島県
江崎駅	山口県
江住駅	和歌山県
越前大野駅	福井県
越前大宮駅	福井県
越前下山駅	福井県
越前高田駅	福井県
越前たけふ駅	福井県
越前田野駅	福井県
越前東郷駅	福井県
越前富田駅	福井県
越前花堂駅	福井県
越前薬師駅	福井県
越中国分駅	富山県
越中中川駅	富山県
越中八尾駅	富山県
越中山田駅	富山県
江原駅	兵庫県
江尾駅	鳥取県
海老江駅	大阪府
円町駅	京都府
王寺駅	奈良県
黄檗駅	京都府
近江今津駅	滋賀県
近江塩津駅	滋賀県
近江高島駅	滋賀県
近江中庄駅	滋賀県
近江八幡駅	滋賀県
近江舞子駅	滋賀県
太市駅	兵庫県
大岩駅	鳥取県
大河内駅	山口県
大阪駅	大阪府
大阪城北詰駅	大阪府
大阪城公園駅	大阪府
大阪天満宮駅	大阪府
大篠津町駅	鳥取県
大住駅	京都府
大竹駅	広島県
大田市駅	島根県
大谷駅	和歌山県
大多羅駅	岡山県
大津駅	滋賀県
大津京駅	滋賀県
大歳駅	山口県
大鳥羽駅	福井県
大富駅	岡山県
鳳駅	大阪府
大野浦駅	広島県
大乗駅	広島県
大畠駅	山口県
大町駅	広島県	佐賀県
大元駅	岡山県
岡見駅	島根県
岡山駅	岡山県
邑久駅	岡山県
おごと温泉駅	滋賀県
刑部駅	岡山県
長船駅	岡山県
小田駅	島根県
小月駅	山口県
小奴可駅	広島県
小野田駅	山口県
小野田港駅	山口県
小野町駅	兵庫県
尾道駅	広島県
小浜駅	福井県
小原駅	岡山県
帯解駅	奈良県
於福駅	山口県
折居駅	島根県
海田市駅	広島県
海南駅	和歌山県
加賀温泉駅	石川県
香登駅	岡山県
嘉川駅	山口県
柿ケ島駅	福井県
香久山駅	奈良県
加古川駅	兵庫県
笠岡駅	岡山県
笠置駅	京都府
風早駅	広島県
梶栗郷台地駅	山口県
梶田駅	広島県
香芝駅	奈良県
加島駅	大阪府
香住駅	兵庫県
笠田駅	和歌山県
堅田駅	滋賀県
勝間駅	山口県
勝間田駅	岡山県
桂川駅	京都府	福岡県
加斗駅	福井県
勝原駅	福井県
金川駅	岡山県
金沢駅	石川県
金橋駅	奈良県
金丸駅	石川県
加太駅	三重県
可部駅	広島県
鎌手駅	島根県
加美駅	大阪府
上石見駅	鳥取県
上嘉川駅	山口県
上川口駅	京都府
上川立駅	広島県
上郷駅	山口県
上郡駅	兵庫県
上狛駅	京都府
神杉駅	広島県
上菅駅	鳥取県
上戸手駅	広島県
上中駅	福井県
上の町駅	岡山県
上深川駅	広島県
上三田駅	広島県
上八木駅	広島県
上夜久野駅	京都府
上山口駅	山口県
亀岡駅	京都府
亀嵩駅	島根県
亀甲駅	岡山県
鴨方駅	岡山県
加茂郷駅	和歌山県
加茂中駅	島根県
唐崎駅	滋賀県
狩留家駅	広島県
かるが浜駅	広島県
河合西駅	兵庫県
河毛駅	滋賀県
河佐駅	広島県
河崎口駅	鳥取県
河瀬駅	滋賀県
川棚温泉駅	山口県
河内磐船駅	大阪府
河内堅上駅	大阪府
川西駅	山口県
川西池田駅	兵庫県
河原駅	鳥取県
川原石駅	広島県
関西空港駅	大阪府
神辺駅	広島県
神野駅	兵庫県
紀伊駅	和歌山県
紀伊有田駅	和歌山県
紀伊内原駅	和歌山県
紀伊浦神駅	和歌山県
紀伊小倉駅	和歌山県
紀伊勝浦駅	和歌山県
紀伊佐野駅	和歌山県
紀伊新庄駅	和歌山県
紀伊田辺駅	和歌山県
紀伊田原駅	和歌山県
紀伊天満駅	和歌山県
紀伊富田駅	和歌山県
紀伊長田駅	和歌山県
紀伊中ノ島駅	和歌山県
紀伊日置駅	和歌山県
紀伊姫駅	和歌山県
紀伊宮原駅	和歌山県
紀伊山田駅	和歌山県
紀伊由良駅	和歌山県
吉舎駅	広島県
岸辺駅	大阪府
岸本駅	鳥取県
木次駅	島根県
衣摺加美北駅	大阪府
北伊丹駅	兵庫県
北宇智駅	奈良県
北大野駅	福井県
北小谷駅	長野県
北小松駅	滋賀県
北信太駅	大阪府
北新地駅	大阪府
北長瀬駅	岡山県
木津駅	京都府
城崎温泉駅	兵庫県
木ノ本駅	滋賀県
木野山駅	岡山県
吉備津駅	岡山県
貴生川駅	滋賀県
来待駅	島根県
木見駅	岡山県
紀三井寺駅	和歌山県
気山駅	福井県
久宝寺駅	大阪府
木与駅	山口県
京口駅	兵庫県
京田辺駅	京都府
京橋駅	大阪府
京終駅	奈良県
清音駅	岡山県
切目駅	和歌山県
岐波駅	山口県
紀和駅	和歌山県
黄波戸駅	山口県
欽明路駅	山口県
玖珂駅	山口県
久々原駅	岡山県
久下村駅	兵庫県
草江駅	山口県
草津駅	滋賀県
櫛ケ浜駅	山口県
串本駅	和歌山県
久代駅	島根県
九頭竜湖駅	福井県
久世駅	岡山県
久谷駅	兵庫県
下松駅	山口県	大阪府
久手駅	島根県
国英駅	鳥取県
玖波駅	広島県
頸城大野駅	新潟県
熊取駅	大阪府
熊山駅	岡山県
玖村駅	広島県
久米田駅	大阪府
倉敷駅	岡山県
倉吉駅	鳥取県
呉駅	広島県
呉ポートピア駅	広島県
黒井村駅	山口県
黒江駅	和歌山県
黒坂駅	鳥取県
黒田庄駅	兵庫県
黒部宇奈月温泉駅	富山県
黒松駅	島根県
玄武洞駅	兵庫県
甲賀駅	滋賀県
豪渓駅	岡山県
甲子園口駅	兵庫県
甲西駅	滋賀県
甲立駅	広島県
河内駅	広島県
江津駅	島根県
上月駅	兵庫県
河戸帆待川駅	広島県
江南駅	島根県
甲南駅	滋賀県
甲南山手駅	兵庫県
甲奴駅	広島県
鴻池新田駅	大阪府
神戸駅	兵庫県
神目駅	岡山県
高野口駅	和歌山県
香呂駅	兵庫県
郡家駅	鳥取県
粉河駅	和歌山県
小串駅	山口県
国府駅	兵庫県
小倉駅	福岡県	福岡県
古座駅	和歌山県
越ケ浜駅	山口県
児島駅	岡山県	岡山県
五条駅	奈良県
御所駅	奈良県
小滝駅	新潟県
御着駅	兵庫県
特牛駅	山口県
厚東駅	山口県
後藤駅	鳥取県
琴芝駅	山口県
木幡駅	京都府
御坊駅	和歌山県
胡麻駅	京都府
小松駅	石川県
古見駅	岡山県
小屋浦駅	広島県
湖山駅	鳥取県
小和清水駅	福井県
金光駅	岡山県
西大寺駅	岡山県
坂駅	広島県
嵯峨嵐山駅	京都府
堺市駅	大阪府
境港駅	鳥取県
坂田駅	滋賀県
坂根駅	岡山県
桜井駅	奈良県
桜島駅	大阪府
さくら夙川駅	兵庫県
桜ノ宮駅	大阪府
坂越駅	兵庫県
笹津駅	富山県
篠山口駅	兵庫県
佐津駅	兵庫県
里庄駅	岡山県
佐那具駅	三重県
佐用駅	兵庫県
佐良山駅	岡山県
三田駅	兵庫県
三ノ宮駅	兵庫県
三本松口駅	鳥取県
三見駅	山口県
JR淡路駅	大阪府
JR小倉駅	京都府
JR河内永和駅	大阪府
JR五位堂駅	奈良県
JR俊徳道駅	大阪府
JR総持寺駅	大阪府
JR長瀬駅	大阪府
JR難波駅	大阪府
JR野江駅	大阪府
JR藤森駅	京都府
JR三山木駅	京都府
塩町駅	広島県
塩屋駅	兵庫県
志賀駅	滋賀県
志紀駅	大阪府
敷浪駅	石川県
鴫野駅	大阪府
寺家駅	広島県
重安駅	山口県
四条畷駅	大阪府
静間駅	島根県
志都美駅	奈良県
七軒茶屋駅	広島県
信太山駅	大阪府
篠原駅	滋賀県
忍ケ丘駅	大阪府
篠目駅	山口県
柴山駅	兵庫県
渋木駅	山口県
地福駅	山口県
島尾駅	富山県
島ケ原駅	三重県
島本駅	大阪府
冷水浦駅	和歌山県
下井阪駅	和歌山県
下市駅	鳥取県
下川辺駅	広島県
下祇園駅	広島県
下久野駅	島根県
下府駅	島根県
下狛駅	京都府
下里駅	和歌山県
下滝駅	兵庫県
下津駅	和歌山県
下関駅	山口県	山口県
下兵庫駅	和歌山県
下深川駅	広島県
下北条駅	鳥取県
下夜久野駅	京都府
下山駅	京都府
下唯野駅	福井県
下和知駅	広島県
上下駅	広島県
城端駅	富山県
荘原駅	島根県
生山駅	鳥取県
城陽駅	京都府
白市駅	広島県
白木山駅	広島県
白浜駅	和歌山県
四郎ケ原駅	山口県
城北公園通駅	大阪府
志和口駅	広島県
志和地駅	広島県
新旭駅	滋賀県
新市駅	広島県
新井口駅	広島県
新今宮駅	大阪府
新岩国駅	山口県
新尾道駅	広島県
新加美駅	大阪府
鍼灸大学前駅	京都府
新倉敷駅	岡山県
新家駅	大阪府
新神戸駅	兵庫県
新三田駅	兵庫県
宍道駅	島根県
新下関駅	山口県
新高岡駅	富山県
新堂駅	三重県
新長田駅	兵庫県
新南陽駅	山口県
新西脇駅	兵庫県
新白島駅	広島県
新疋田駅	福井県
新平野駅	福井県
新広駅	広島県
新福島駅	大阪府
新山口駅	山口県
吹田駅	大阪府
末恒駅	鳥取県
周防久保駅	山口県
周防佐山駅	山口県
周防下郷駅	山口県
周防高森駅	山口県
周防花岡駅	山口県
杉本町駅	大阪府
須佐駅	山口県
周参見駅	和歌山県
雀田駅	山口県
隅田駅	和歌山県
須波駅	広島県
周布駅	島根県
須磨駅	兵庫県
須磨海浜公園駅	兵庫県
住道駅	大阪府
住吉駅	兵庫県	熊本県
勢浜駅	福井県
関駅	三重県
膳所駅	滋賀県
瀬田駅	滋賀県	熊本県
摂津富田駅	大阪府
摂津本山駅	兵庫県
瀬戸駅	岡山県
瀬野駅	広島県
妹尾駅	岡山県
仙崎駅	山口県
千旦駅	和歌山県
千本駅	兵庫県
千里丘駅	大阪府
寒河駅	岡山県
総社駅	岡山県
曽根駅	兵庫県
園部駅	京都府
大安寺駅	岡山県
太地駅	和歌山県
大正駅	大阪府
大山口駅	鳥取県
大道駅	山口県
田井ノ瀬駅	和歌山県
大門駅	広島県
高駅	広島県
高井田駅	大阪府
高井田中央駅	大阪府
高岡駅	富山県
鷹狩駅	鳥取県
高儀駅	富山県
高木駅	広島県
高島駅	岡山県
高田駅	奈良県	長崎県
高津駅	京都府
高月駅	滋賀県
高槻駅	大阪府
鷹取駅	兵庫県
高野駅	岡山県
高松駅	石川県	香川県
高松町駅	鳥取県
高水駅	山口県
宝塚駅	兵庫県
田儀駅	島根県
滝野駅	兵庫県
滝部駅	山口県
竹田駅	兵庫県
武田尾駅	兵庫県
竹野駅	兵庫県
竹原駅	広島県
建部駅	岡山県
田子駅	和歌山県
丹治部駅	岡山県
忠海駅	広島県
立木駅	京都府
立花駅	兵庫県
竜野駅	兵庫県
棚倉駅	京都府
田並駅	和歌山県
谷川駅	兵庫県
田布施駅	山口県
玉江駅	山口県
玉柏駅	岡山県
玉造駅	大阪府
玉造温泉駅	島根県
玉手駅	奈良県
玉水駅	京都府
田村駅	滋賀県
垂水駅	兵庫県
誕生寺駅	岡山県
丹波大山駅	兵庫県
丹波口駅	京都府
丹波竹田駅	兵庫県
近田駅	広島県
千里駅	富山県
千路駅	石川県
智頭駅	鳥取県
茶屋町駅	岡山県
中国勝山駅	岡山県
長府駅	山口県
長門峡駅	山口県
千代川駅	京都府
知和駅	岡山県
塚口駅	兵庫県
塚本駅	大阪府
月ケ瀬口駅	京都府
月田駅	岡山県
津久野駅	大阪府
柘植駅	三重県
津田駅	大阪府
土山駅	兵庫県
通津駅	山口県
常山駅	岡山県
津ノ井駅	鳥取県
都野津駅	島根県
椿駅	和歌山県
津幡駅	石川県
坪井駅	岡山県
妻崎駅	山口県
津山駅	岡山県
津山口駅	岡山県
鶴居駅	兵庫県
敦賀駅	福井県
鶴ケ丘駅	大阪府
鶴橋駅	大阪府
津和野駅	島根県
手原駅	滋賀県
寺庄駅	滋賀県
寺田町駅	大阪府
寺前駅	兵庫県
天神川駅	広島県
天応駅	広島県
天王寺駅	大阪府
天満駅	大阪府
天理駅	奈良県
天和駅	兵庫県
戸出駅	富山県
道後山駅	広島県
同志社前駅	京都府
東城駅	広島県
道場駅	兵庫県
道成寺駅	和歌山県
東福寺駅	京都府
東部市場前駅	大阪府
常盤駅	山口県
徳庵駅	大阪府
徳佐駅	山口県
徳田駅	石川県
徳山駅	山口県
床波駅	山口県
戸田小浜駅	島根県
鳥取駅	鳥取県
鳥取大学前駅	鳥取県
戸手駅	広島県
砺波駅	富山県
富木駅	大阪府
富海駅	山口県
砥堀駅	兵庫県
泊駅	鳥取県
富原駅	岡山県
十村駅	福井県
富山駅	富山県
豊岡駅	兵庫県
虎姫駅	滋賀県
直江駅	島根県
長居駅	大阪府
長池駅	京都府
中飯降駅	和歌山県
長尾駅	大阪府
長岡京駅	京都府
中島駅	広島県
中庄駅	岡山県
長滝駅	大阪府
中土駅	長野県
中津幡駅	石川県
長門粟野駅	山口県
長門大井駅	山口県
長門市駅	山口県
長門長沢駅	山口県
長門二見駅	山口県
長門古市駅	山口県
長門三隅駅	山口県
長門本山駅	山口県
長門湯本駅	山口県
中野東駅	広島県
中畑駅	広島県
中浜駅	鳥取県
長浜駅	滋賀県
永原駅	滋賀県
中深川駅	広島県
中三田駅	広島県
中山口駅	鳥取県
中山寺駅	兵庫県
長柄駅	奈良県
那岐駅	鳥取県
名草駅	山口県
奈古駅	山口県
灘駅	兵庫県
那智駅	和歌山県
名手駅	和歌山県
七尾駅	石川県
七塚駅	広島県
鍋倉駅	山口県
生瀬駅	兵庫県
並河駅	京都府
奈良駅	奈良県
楢原駅	岡山県
平城山駅	奈良県
名和駅	鳥取県
新井駅	兵庫県
新郷駅	岡山県
新野駅	兵庫県	徳島県
新見駅	岡山県
仁方駅	広島県
西相生駅	兵庫県
西明石駅	兵庫県
西阿知駅	岡山県
西出雲駅	島根県
西岩国駅	山口県
西大路駅	京都府
西笠田駅	和歌山県
西片上駅	岡山県
西勝間田駅	岡山県
西川原駅	岡山県
西木津駅	京都府
西九条駅	大阪府
西栗栖駅	兵庫県
西高屋駅	広島県
西敦賀駅	福井県
西富山駅	富山県
西宮駅	兵庫県
西宮名塩駅	兵庫県
西浜田駅	島根県
西広島駅	広島県
西舞鶴駅	京都府
西三次駅	広島県
二条駅	京都府
西脇市駅	兵庫県
日原駅	島根県
仁豊野駅	兵庫県
仁保駅	山口県
仁保津駅	山口県
日本へそ公園駅	兵庫県
仁万駅	島根県
入野駅	広島県	鹿児島県
楡原駅	富山県
庭瀬駅	岡山県
布原駅	岡山県
根雨駅	鳥取県
根知駅	新潟県
寝屋川公園駅	大阪府
能町駅	富山県
乃木駅	島根県
野里駅	兵庫県
能瀬駅	石川県
野田駅	大阪府
野馳駅	岡山県
能登川駅	滋賀県
能登二宮駅	石川県
能登部駅	石川県
野々口駅	岡山県
梅林駅	広島県
博多駅	福岡県	福岡県
博多南駅	福岡県
計石駅	福井県
萩駅	山口県
羽咋駅	石川県
博労町駅	鳥取県
迫川駅	岡山県
波子駅	島根県
土師駅	鳥取県
柱野駅	山口県
長谷駅	兵庫県
畠田駅	奈良県
幡生駅	山口県
幡屋駅	島根県
八浜駅	岡山県
八本松駅	広島県
廿日市駅	広島県
初島駅	和歌山県
服部駅	岡山県
花園駅	京都府
放出駅	大阪府
波根駅	島根県
馬場崎町駅	鳥取県
埴生駅	山口県
浜河内駅	山口県
浜坂駅	兵庫県
浜田駅	島根県
浜村駅	鳥取県
芳養駅	和歌山県
林駅	富山県
林野駅	岡山県
早島駅	岡山県
速星駅	富山県
はりま勝原駅	兵庫県
播磨新宮駅	兵庫県
播磨高岡駅	兵庫県
播磨徳久駅	兵庫県
播州赤穂駅	兵庫県
比延駅	兵庫県
比叡山坂本駅	滋賀県
日岡駅	兵庫県
東青原駅	島根県
東石黒駅	富山県
東岡山駅	岡山県
東尾道駅	広島県
東小浜駅	福井県
東貝塚駅	大阪府
東加古川駅	兵庫県
東岸和田駅	大阪府
東郡家駅	鳥取県
東佐野駅	大阪府
東新川駅	山口県
東総社駅	岡山県
東津山駅	岡山県
東野尻駅	富山県
東萩駅	山口県
東羽衣駅	大阪府
東觜崎駅	兵庫県
東浜駅	鳥取県
東姫路駅	兵庫県
東広島駅	広島県
東福山駅	広島県
東舞鶴駅	京都府
東松江駅	島根県
東美浜駅	福井県
東八尾駅	富山県
東山公園駅	鳥取県
東淀川駅	大阪府
光駅	山口県
彦崎駅	岡山県
彦根駅	滋賀県
美章園駅	大阪府
備前一宮駅	岡山県
備前片岡駅	岡山県
備前片上駅	岡山県
備前田井駅	岡山県
備前西市駅	岡山県
備前原駅	岡山県
備前福河駅	兵庫県
備前三門駅	岡山県
備中川面駅	岡山県
備中神代駅	岡山県
備中高梁駅	岡山県
備中高松駅	岡山県
備中広瀬駅	岡山県
備中箕島駅	岡山県
人丸駅	山口県
日生駅	岡山県
日根野駅	大阪府
日登駅	島根県
比婆山駅	広島県
氷見駅	富山県
姫川駅	新潟県
姫路駅	兵庫県
ひめじ別所駅	兵庫県
兵庫駅	兵庫県
日吉駅	京都府
比良駅	滋賀県
平岩駅	新潟県
平子駅	広島県
平野駅	大阪府
広駅	広島県
広川ビーチ駅	和歌山県
広島駅	広島県
日羽駅	岡山県
備後赤坂駅	広島県
備後落合駅	広島県
備後西城駅	広島県
備後庄原駅	広島県
備後本庄駅	広島県
備後三川駅	広島県
備後三日市駅	広島県
備後安田駅	広島県
備後矢野駅	広島県
備後八幡駅	広島県
深溝駅	山口県
福井駅	福井県
福江駅	山口県
福川駅	山口県
福崎駅	兵庫県
福知山駅	京都府
福野駅	富山県
福部駅	鳥取県
福光駅	富山県
福山駅	広島県
福渡駅	岡山県
藤井駅	福井県
伏木駅	富山県
藤阪駅	大阪府
藤並駅	和歌山県
富士見町駅	鳥取県
藤生駅	山口県
二塚駅	富山県
淵垣駅	京都府
府中駅	広島県	徳島県
婦中鵜坂駅	富山県
船戸駅	和歌山県
船平山駅	山口県
船町口駅	兵庫県
古市駅	兵庫県
古市橋駅	広島県
戸坂駅	広島県
弁天町駅	大阪府
法界院駅	岡山県
宝木駅	鳥取県
伯耆大山駅	鳥取県
伯耆溝口駅	鳥取県
方谷駅	岡山県
祝園駅	京都府
宝達駅	石川県
宝殿駅	兵庫県
防府駅	山口県
蓬莱駅	滋賀県
法隆寺駅	奈良県
星田駅	大阪府
布施屋駅	和歌山県
保津峡駅	京都府
本黒田駅	兵庫県
本郷駅	広島県
本竜野駅	兵庫県
本津幡駅	石川県
本俣賀駅	島根県
本由良駅	山口県
舞子駅	兵庫県
前空駅	広島県
マキノ駅	滋賀県
巻向駅	奈良県
牧山駅	岡山県
真倉駅	京都府
馬路駅	島根県
益田駅	島根県
松井山手駅	京都府
松江駅	島根県
松崎駅	鳥取県
松永駅	広島県
松尾寺駅	京都府
万能倉駅	広島県
摩耶駅	兵庫県
丸尾駅	山口県
万富駅	岡山県
三井野原駅	島根県
三浦駅	岡山県
三方駅	福井県
三日月駅	兵庫県
三国ケ丘駅	大阪府
三雲駅	滋賀県
御来屋駅	鳥取県
水尻駅	広島県
溝口駅	兵庫県
三滝駅	広島県
三谷駅	山口県
道上駅	広島県
三石駅	岡山県
三松駅	福井県
御幣島駅	大阪府
緑井駅	広島県
美袋駅	岡山県
南部駅	和歌山県
南岩国駅	山口県
南大嶺駅	山口県
南小野田駅	山口県
南草津駅	滋賀県
南宍道駅	島根県
南吹田駅	大阪府
南大東駅	島根県
南田辺駅	大阪府
南中川駅	山口県
南羽咋駅	石川県
南彦根駅	滋賀県
南矢代駅	兵庫県
美祢駅	山口県
箕島駅	和歌山県
美浜駅	福井県
三原駅	広島県
三保三隅駅	島根県
美作江見駅	岡山県
美作追分駅	岡山県
美作大崎駅	岡山県
美作落合駅	岡山県
美作加茂駅	岡山県
美作河井駅	岡山県
美作千代駅	岡山県
美作滝尾駅	岡山県
美作土居駅	岡山県
宮内串戸駅	広島県
宮島口駅	広島県
宮野駅	山口県
美山駅	福井県
宮前駅	和歌山県
妙寺駅	和歌山県
三次駅	広島県
三良坂駅	広島県
見老津駅	和歌山県
三輪駅	奈良県
三輪崎駅	和歌山県
向洋駅	広島県
向原駅	広島県
武庫駅	鳥取県
向日町駅	京都府
六十谷駅	和歌山県
目出駅	山口県
免田駅	石川県
百舌鳥駅	大阪府
用瀬駅	鳥取県
元町駅	兵庫県
桃谷駅	大阪府
桃山駅	京都府
森ノ宮駅	大阪府
守山駅	滋賀県
諸寄駅	兵庫県
八尾駅	大阪府
矢賀駅	広島県
矢神駅	岡山県
八川駅	島根県
八木駅	京都府
厄神駅	兵庫県
社町駅	兵庫県
野洲駅	滋賀県
安浦駅	広島県
安岡駅	山口県
安来駅	島根県
八次駅	広島県
柳井駅	山口県
柳井港駅	山口県
柳本駅	奈良県
梁瀬駅	兵庫県
矢野駅	広島県
八橋駅	鳥取県
矢原駅	山口県
養父駅	兵庫県
山家駅	京都府
山口駅	山口県
山科駅	京都府
山城青谷駅	京都府
山城多賀駅	京都府
大和小泉駅	奈良県
大和新庄駅	奈良県
大和二見駅	奈良県
山中渓駅	大阪府
山ノ内駅	広島県
湯浅駅	和歌山県
由宇駅	山口県
湯川駅	和歌山県
油木駅	広島県
弓削駅	岡山県
湯里駅	島根県
湯田温泉駅	山口県
湯玉駅	山口県
湯田村駅	広島県
ユニバーサルシティ駅	大阪府
温泉津駅	島根県
湯ノ峠駅	山口県
弓ケ浜駅	鳥取県
由良駅	鳥取県
八鹿駅	兵庫県
余呉駅	滋賀県
横尾駅	広島県
横山駅	石川県
吉浦駅	広島県
良川駅	石川県
吉田口駅	広島県
吉富駅	京都府	福岡県
吉名駅	広島県
吉永駅	岡山県
吉野口駅	奈良県
吉見駅	山口県
四辻駅	山口県
淀江駅	鳥取県
米子駅	鳥取県
米子空港駅	鳥取県
米川駅	山口県
余部駅	兵庫県
鎧駅	兵庫県
栗東駅	滋賀県
りんくうタウン駅	大阪府
六地蔵駅	京都府
六条駅	福井県
六甲道駅	兵庫県
若狭有田駅	福井県
若狭高浜駅	福井県
若狭本郷駅	福井県
若狭和田駅	福井県
和歌山駅	和歌山県
和歌山市駅	和歌山県
和木駅	山口県
掖上駅	奈良県
和倉温泉駅	石川県
和気駅	岡山県
和佐駅	和歌山県
和田浜駅	鳥取県
和田岬駅	兵庫県
和田山駅	兵庫県
渡川駅	山口県
和知駅	京都府
和邇駅	滋賀県
和深駅	和歌山県
赤星駅	愛媛県
鮎喰駅	徳島県
浅川駅	徳島県
朝倉駅	高知県
浅海駅	愛媛県
吾桑駅	高知県
薊野駅	高知県
穴吹駅	徳島県
阿南駅	徳島県
安和駅	高知県
阿波赤石駅	徳島県
粟井駅	愛媛県
阿波池田駅	徳島県
阿波大谷駅	徳島県
阿波大宮駅	徳島県
阿波海南駅	徳島県
阿波加茂駅	徳島県
阿波川口駅	徳島県
阿波川島駅	徳島県
阿波川端駅	徳島県
阿波橘駅	徳島県
阿波富田駅	徳島県
阿波中島駅	徳島県
阿波半田駅	徳島県
阿波福井駅	徳島県
阿波山川駅	徳島県
家地川駅	高知県
五十崎駅	愛媛県
池谷駅	徳島県
石井駅	徳島県
石鎚山駅	愛媛県
出目駅	愛媛県
板野駅	徳島県
市坪駅	愛媛県
伊野駅	高知県
今治駅	愛媛県
祖谷口駅	徳島県
伊予出石駅	愛媛県
伊予石城駅	愛媛県
伊予大洲駅	愛媛県
伊予大平駅	愛媛県
伊予上灘駅	愛媛県
伊予亀岡駅	愛媛県
伊予小松駅	愛媛県
伊予西条駅	愛媛県
伊予桜井駅	愛媛県
伊予寒川駅	愛媛県
伊予市駅	愛媛県
伊予白滝駅	愛媛県
伊予立川駅	愛媛県
伊予土居駅	愛媛県
伊予富田駅	愛媛県
伊予長浜駅	愛媛県
伊予中山駅	愛媛県
伊予氷見駅	愛媛県
伊予平野駅	愛媛県
伊予北条駅	愛媛県
伊予三島駅	愛媛県
伊予宮野下駅	愛媛県
伊予三芳駅	愛媛県
伊予横田駅	愛媛県
伊予吉田駅	愛媛県
伊予和気駅	愛媛県
入明駅	高知県
牛島駅	徳島県
宇多津駅	香川県
内子駅	愛媛県
打井川駅	高知県
卯之町駅	愛媛県
宇和島駅	愛媛県
江川崎駅	高知県
江口駅	徳島県
枝川駅	高知県
襟野々駅	高知県
円行寺口駅	高知県
麻植塚駅	徳島県
大内駅	愛媛県
大浦駅	愛媛県
大杉駅	高知県
大田口駅	高知県
大西駅	愛媛県
多ノ郷駅	高知県
大歩危駅	徳島県
大間駅	高知県
岡花駅	高知県
小島駅	徳島県
小村神社前駅	高知県
オレンジタウン駅	香川県
海岸寺駅	香川県
学駅	徳島県
角茂谷駅	高知県
影野駅	高知県
上宇和駅	愛媛県
鴨川駅	香川県
鴨島駅	徳島県
川田駅	徳島県
川之江駅	愛媛県
観音寺駅	香川県
神前駅	香川県
木岐駅	徳島県
菊間駅	愛媛県
北伊予駅	愛媛県
北宇和島駅	愛媛県
北河内駅	徳島県
木太町駅	香川県
喜多灘駅	愛媛県
喜多山駅	愛媛県
鬼無駅	香川県
教会前駅	徳島県
日下駅	高知県
串駅	愛媛県
窪川駅	高知県
蔵本駅	徳島県
黒川駅	香川県
桑野駅	徳島県
香西駅	香川県
高知駅	高知県
高知商業前駅	高知県
高野川駅	愛媛県
光洋台駅	愛媛県
国分駅	香川県	鹿児島県
琴平駅	香川県
小歩危駅	徳島県
後免駅	高知県
五郎駅	愛媛県
金蔵寺駅	香川県
金比羅前駅	徳島県
坂出駅	香川県
佐川駅	高知県
佐古駅	徳島県
貞光駅	徳島県
讃岐相生駅	香川県
讃岐財田駅	香川県
讃岐塩屋駅	香川県
讃岐白鳥駅	香川県
讃岐津田駅	香川県
讃岐府中駅	香川県
讃岐牟礼駅	香川県
鯖瀬駅	徳島県
三本松駅	香川県
塩入駅	香川県
繁藤駅	高知県
地蔵橋駅	徳島県
志度駅	香川県
下浦駅	徳島県
下宇和駅	愛媛県
下灘駅	愛媛県
勝瑞駅	徳島県
昭和町駅	香川県
新改駅	高知県
須崎駅	高知県
関川駅	愛媛県
千丈駅	愛媛県
善通寺駅	香川県
造田駅	香川県
田井ノ浜(臨)駅	徳島県
高光駅	愛媛県
多喜浜駅	愛媛県
詫間駅	香川県
立間駅	愛媛県
立江駅	徳島県
立道駅	徳島県
多度津駅	香川県
玉之江駅	愛媛県
近永駅	愛媛県
佃駅	徳島県
辻駅	徳島県
津島ノ宮(臨)駅	香川県
坪尻駅	徳島県
鶴羽駅	香川県
十川駅	高知県
斗賀野駅	高知県
徳島駅	徳島県
土佐穴内駅	高知県
土佐一宮駅	高知県
土佐岩原駅	高知県
土佐大津駅	高知県
土佐加茂駅	高知県
土佐北川駅	高知県
土佐久礼駅	高知県
土佐昭和駅	高知県
土佐新荘駅	高知県
土佐大正駅	高知県
土佐長岡駅	高知県
土佐山田駅	高知県
豊永駅	高知県
豊浜駅	香川県
鳥ノ木駅	愛媛県
中萩駅	愛媛県
波方駅	愛媛県
鳴門駅	徳島県
新居浜駅	愛媛県
新谷駅	愛媛県
二軒屋駅	徳島県
西麻植駅	徳島県
西大洲駅	愛媛県
西ケ方駅	高知県
西佐川駅	高知県
西原駅	徳島県
丹生駅	香川県
壬生川駅	愛媛県
布師田駅	高知県
波川駅	高知県
半家駅	高知県
端岡駅	香川県
箸蔵駅	徳島県
波止浜駅	愛媛県
八多喜駅	愛媛県
羽ノ浦駅	徳島県
春賀駅	愛媛県
板東駅	徳島県
引田駅	香川県
比地大駅	香川県
日和佐駅	徳島県
深田駅	愛媛県
双岩駅	愛媛県
二名駅	愛媛県
古高松南駅	香川県
文化の森駅	徳島県
辺川駅	徳島県
堀江駅	愛媛県
真土駅	愛媛県
松丸駅	愛媛県
松山駅	愛媛県
丸亀駅	香川県
三加茂駅	徳島県
三津浜駅	愛媛県
南伊予駅	愛媛県
南小松島駅	徳島県
三縄駅	徳島県
みの駅	香川県
箕浦駅	香川県
見能林駅	徳島県
向井原駅	愛媛県
牟岐駅	徳島県
務田駅	愛媛県
撫養駅	徳島県
本山駅	香川県
八栗口駅	香川県
屋島駅	香川県
八十場駅	香川県
山河内駅	徳島県
山瀬駅	徳島県
山田西町駅	高知県
八幡浜駅	愛媛県
由岐駅	徳島県
吉成駅	徳島県
吉野生駅	愛媛県
栗林駅	香川県
栗林公園北口駅	香川県
六反地駅	高知県
若井駅	高知県
姶良駅	鹿児島県
青井岳駅	宮崎県
青島駅	宮崎県
赤瀬駅	熊本県
赤間駅	福岡県
赤水駅	熊本県
朝地駅	大分県
旭ケ丘駅	宮崎県
浅海井駅	大分県
阿蘇駅	熊本県
油津駅	宮崎県
安部山公園駅	福岡県
天ケ瀬駅	大分県
天津駅	大分県
荒木駅	福岡県
有佐駅	熊本県
有田駅	佐賀県
飯塚駅	福岡県
伊賀駅	福岡県
伊賀屋駅	佐賀県
一貴山駅	福岡県
池尻駅	福岡県
いこいの村駅	熊本県
諫早駅	長崎県
石打ダム駅	熊本県
石垣駅	鹿児島県
石田駅	福岡県
石原町駅	福岡県
伊集院駅	鹿児島県
出水駅	鹿児島県
五十市駅	宮崎県
市来駅	鹿児島県
市棚駅	宮崎県
市布駅	長崎県
市ノ川駅	熊本県
一勝地駅	熊本県
一本松駅	福岡県
糸島高校前駅	福岡県
犬飼駅	大分県
伊比井駅	宮崎県
指宿駅	鹿児島県
今宿駅	福岡県
今津駅	大分県
今山駅	大分県
伊万里駅	佐賀県
岩松駅	長崎県
岩屋駅	佐賀県
植木駅	熊本県
植村駅	鹿児島県
うきは駅	福岡県
宇佐駅	大分県
牛津駅	佐賀県
宇宿駅	鹿児島県
臼杵駅	大分県
内海駅	宮崎県
内之田駅	宮崎県
内牧駅	熊本県
現川駅	長崎県
宇土駅	熊本県
宇島駅	福岡県
宇美駅	福岡県
海ノ中道駅	福岡県
浦上駅	長崎県
浦田駅	福岡県
嬉野温泉駅	佐賀県
運動公園駅	宮崎県
頴娃駅	鹿児島県
頴娃大川駅	鹿児島県
枝光駅	福岡県
海老津駅	福岡県
えびの駅	宮崎県
えびの飯野駅	宮崎県
えびの上江駅	宮崎県
恵良駅	大分県
網田駅	熊本県
相知駅	佐賀県
小江駅	長崎県
大分駅	大分県
大分大学前駅	大分県
大神駅	大分県
大川野駅	佐賀県
大草駅	長崎県
大在駅	大分県
大隅大川原駅	鹿児島県
大隅夏井駅	鹿児島県
大隅横川駅	鹿児島県
大鶴駅	大分県
大堂津駅	宮崎県
大野下駅	熊本県
大野城駅	福岡県
大牟田駅	福岡県
大村駅	長崎県
大村車両基地駅	長崎県
大山駅	鹿児島県
緒方駅	大分県
小川駅	熊本県
小城駅	佐賀県
小串郷駅	長崎県
奥洞海駅	福岡県
大畑駅	熊本県
鬼瀬駅	大分県
鬼塚駅	佐賀県
小野屋駅	大分県
小波瀬西工大前駅	福岡県
飫肥駅	宮崎県
折尾駅	福岡県
折生迫駅	宮崎県
遠賀川駅	福岡県
海崎駅	大分県
海路駅	熊本県
開聞駅	鹿児島県
賀来駅	大分県
鹿児島駅	鹿児島県
鹿児島中央駅	鹿児島県
香椎駅	福岡県
香椎神宮駅	福岡県
加治木駅	鹿児島県
春日駅	福岡県
勝野駅	福岡県
門川駅	宮崎県
門松駅	福岡県
金石原駅	佐賀県
加納駅	宮崎県
加布里駅	福岡県
鎌瀬駅	熊本県
上有田駅	佐賀県
上伊集院駅	鹿児島県
上伊万里駅	佐賀県
上臼杵駅	大分県
上岡駅	大分県
上熊本駅	熊本県
上穂波駅	福岡県
上三緒駅	福岡県
神村学園前駅	鹿児島県
亀川駅	大分県
唐津駅	佐賀県
狩生駅	大分県
嘉例川駅	鹿児島県
川尻駅	熊本県
川棚駅	長崎県
川南駅	宮崎県
香春駅	福岡県
神埼駅	佐賀県
苅田駅	福岡県
雁ノ巣駅	福岡県
歓遊舎ひこさん駅	福岡県
喜入駅	鹿児島県
喜々津駅	長崎県
北方駅	佐賀県
北川駅	宮崎県
北郷駅	宮崎県
北永野田駅	鹿児島県
北延岡駅	宮崎県
北俣駅	鹿児島県
北山田駅	大分県
杵築駅	大分県
城戸南蔵院前駅	福岡県
木花駅	宮崎県
基山駅	佐賀県
九産大前駅	福岡県
九州工大前駅	福岡県
球泉洞駅	熊本県
九大学研都市駅	福岡県
厳木駅	佐賀県
教育大前駅	福岡県
京町温泉駅	宮崎県
清武駅	宮崎県
霧島温泉駅	鹿児島県
霧島神宮駅	鹿児島県
錦江駅	鹿児島県
銀水駅	福岡県
朽網駅	福岡県
串木野駅	鹿児島県
串間駅	宮崎県
久保田駅	佐賀県
熊崎駅	大分県
隈之城駅	鹿児島県
熊本駅	熊本県
鞍手駅	福岡県
栗野駅	鹿児島県
久留米駅	福岡県
久留米高校前駅	福岡県
久留米大学前駅	福岡県
九郎原駅	福岡県
黒崎駅	福岡県
けやき台駅	佐賀県
五位野駅	鹿児島県
幸崎駅	大分県
小内海駅	宮崎県
江北駅	佐賀県
郡元駅	鹿児島県
古賀駅	福岡県
小竹駅	福岡県
子供の国駅	宮崎県
小長井駅	長崎県
木葉駅	熊本県
木場茶屋駅	鹿児島県
駒鳴駅	佐賀県
小森江駅	福岡県
御領駅	鹿児島県
佐伯駅	大分県
財光寺駅	宮崎県
採銅所駅	福岡県
西戸崎駅	福岡県
佐賀駅	佐賀県
酒殿駅	福岡県
坂ノ市駅	大分県
坂之上駅	鹿児島県
坂本駅	熊本県
篠栗駅	福岡県
笹原駅	福岡県
佐志生駅	大分県
佐世保駅	長崎県
薩摩板敷駅	鹿児島県
薩摩今和泉駅	鹿児島県
薩摩川尻駅	鹿児島県
薩摩塩屋駅	鹿児島県
薩摩松元駅	鹿児島県
佐土原駅	宮崎県
佐里駅	佐賀県
三里木駅	熊本県
志井駅	福岡県
志井公園駅	福岡県
椎田駅	福岡県
鹿家駅	福岡県
敷戸駅	大分県
重岡駅	大分県
重富駅	鹿児島県
慈眼寺駅	鹿児島県
ししぶ駅	福岡県
下ノ江駅	大分県
志布志駅	鹿児島県
下鴨生駅	福岡県
下曽根駅	福岡県
下山門駅	福岡県
庄内駅	大分県
城野駅	福岡県
新飯塚駅	福岡県
新大牟田駅	福岡県
新大村駅	長崎県
新宮中央駅	福岡県
新水前寺駅	熊本県
新玉名駅	熊本県
新田原駅	福岡県
新鳥栖駅	佐賀県
新入駅	福岡県
陣原駅	福岡県
新原駅	福岡県
新水俣駅	熊本県
新八代駅	熊本県
水前寺駅	熊本県
須恵駅	福岡県
須恵中央駅	福岡県
菅尾駅	大分県
杉河内駅	大分県
周船寺駅	福岡県
スペースワールド駅	福岡県
諏訪駅	長崎県
瀬々串駅	鹿児島県
瀬高駅	福岡県
瀬戸石駅	熊本県
仙巌園駅	鹿児島県
千丁駅	熊本県
善導寺駅	福岡県
崇城大学前駅	熊本県
宗太郎駅	大分県
添田駅	福岡県
曽山寺駅	宮崎県
彼杵駅	長崎県
大行司駅	福岡県
大塔駅	長崎県
大入駅	福岡県
高崎新田駅	宮崎県
高城駅	大分県
高鍋駅	宮崎県
高橋駅	佐賀県
高原駅	宮崎県
財部駅	鹿児島県
田川伊田駅	福岡県
田川後藤寺駅	福岡県
滝尾駅	大分県
滝水駅	熊本県
多久駅	佐賀県
武雄温泉駅	佐賀県
竹下駅	福岡県
竹中駅	大分県
竹松駅	長崎県
田代駅	佐賀県
竜田口駅	熊本県
立石駅	大分県
立野駅	熊本県
谷頭駅	宮崎県
谷之口駅	宮崎県
谷山駅	鹿児島県
田主丸駅	福岡県
田野駅	宮崎県
田原坂駅	熊本県
玉名駅	熊本県
玉来駅	大分県
田吉駅	宮崎県
多良駅	佐賀県
段駅	熊本県
筑後大石駅	福岡県
筑後草野駅	福岡県
筑後船小屋駅	福岡県
筑後吉井駅	福岡県
筑前岩屋駅	福岡県
筑前植木駅	福岡県
筑前内野駅	福岡県
筑前庄内駅	福岡県
筑前大分駅	福岡県
筑前垣生駅	福岡県
筑前深江駅	福岡県
筑前前原駅	福岡県
筑前山家駅	福岡県
筑前山手駅	福岡県
千鳥駅	福岡県
千早駅	福岡県
帖佐駅	鹿児島県
長者原駅	福岡県
千綿駅	長崎県
築城駅	福岡県
津久見駅	大分県
都農駅	宮崎県
鶴崎駅	大分県
鶴丸駅	鹿児島県
光岡駅	大分県
天神山駅	大分県
天道駅	福岡県
天拝山駅	福岡県
土井駅	福岡県
東海学園前駅	熊本県
東郷駅	福岡県
鳥栖駅	佐賀県
土々呂駅	宮崎県
戸畑駅	福岡県
都府楼南駅	福岡県
富合駅	熊本県
直川駅	大分県
直見駅	大分県
永尾駅	佐賀県
長崎駅	長崎県
長里駅	長崎県
長洲駅	熊本県
中多久駅	佐賀県
中津駅	大分県
中原駅	佐賀県
中判田駅	大分県
中福良駅	鹿児島県
中間駅	福岡県
中名駅	鹿児島県
中山香駅	大分県
長与駅	長崎県
奈多駅	福岡県
鍋島駅	佐賀県
鯰田駅	福岡県
波野駅	熊本県
那良口駅	熊本県
南郷駅	宮崎県
二月田駅	鹿児島県
西諫早駅	長崎県
西浦上駅	長崎県
西頴娃駅	鹿児島県
西相知駅	佐賀県
西大分駅	大分県
西大山駅	鹿児島県
西唐津駅	佐賀県
西熊本駅	熊本県
西小倉駅	福岡県
西小林駅	宮崎県
西里駅	熊本県
西添田駅	福岡県
虹ノ松原駅	佐賀県
西人吉駅	熊本県
西都城駅	宮崎県
西牟田駅	福岡県
西屋敷駅	大分県
日南駅	宮崎県
生見駅	鹿児島県
直方駅	福岡県
延岡駅	宮崎県
野矢駅	大分県
早岐駅	長崎県
羽犬塚駅	福岡県
ハウステンボス駅	長崎県
南風崎駅	長崎県
葉木駅	熊本県
箱崎駅	福岡県
蓮ケ池駅	宮崎県
波多浦駅	熊本県
波多江駅	福岡県
浜崎駅	佐賀県
隼人駅	鹿児島県
原水駅	熊本県
バルーンさが(臨)駅	佐賀県
原田駅	福岡県
原町駅	福岡県
日宇駅	長崎県
東諫早駅	長崎県
東市来駅	鹿児島県
東開聞駅	鹿児島県
東唐津駅	佐賀県
東園駅	長崎県
東高崎駅	宮崎県
東多久駅	佐賀県
東都農駅	宮崎県
東中津駅	大分県
東福間駅	福岡県
東別府駅	大分県
東水巻駅	福岡県
光の森駅	熊本県
引治駅	大分県
肥後伊倉駅	熊本県
肥後大津駅	熊本県
彦山駅	福岡県
肥後長浜駅	熊本県
日出駅	大分県
日代駅	大分県
肥前旭駅	佐賀県
肥前飯田駅	佐賀県
肥前大浦駅	佐賀県
肥前鹿島駅	佐賀県
肥前久保駅	佐賀県
肥前古賀駅	長崎県
肥前白石駅	佐賀県
肥前長田駅	長崎県
肥前長野駅	佐賀県
肥前七浦駅	佐賀県
肥前浜駅	佐賀県
肥前麓駅	佐賀県
肥前竜王駅	佐賀県
日田駅	大分県
人吉駅	熊本県
日当山駅	鹿児島県
日向大束駅	宮崎県
日向北方駅	宮崎県
日向沓掛駅	宮崎県
日向市駅	宮崎県
日向庄内駅	宮崎県
日向新富駅	宮崎県
日向住吉駅	宮崎県
日向長井駅	宮崎県
日向前田駅	宮崎県
表木山駅	鹿児島県
平川駅	鹿児島県
広木駅	鹿児島県
広原駅	宮崎県
福島今町駅	宮崎県
福島高松駅	宮崎県
福間駅	福岡県
福吉駅	福岡県
藤ノ木駅	福岡県
豊前川崎駅	福岡県
豊前松江駅	福岡県
豊前善光寺駅	大分県
豊前長洲駅	大分県
豊前桝田駅	福岡県
二島駅	福岡県
二日市駅	福岡県
福工大前駅	福岡県
船尾駅	福岡県
古国府駅	大分県
豊後荻駅	大分県
豊後清川駅	大分県
豊後国分駅	大分県
豊後竹田駅	大分県
豊後豊岡駅	大分県
豊後中川駅	大分県
豊後中村駅	大分県
豊後三芳駅	大分県
豊後森駅	大分県
平成駅	熊本県
別府駅	大分県
別府大学駅	大分県
宝珠山駅	福岡県
本川内駅	長崎県
本城駅	福岡県
本牟田部駅	佐賀県
舞松原駅	福岡県
前之浜駅	鹿児島県
牧駅	大分県
枕崎駅	鹿児島県
真幸駅	宮崎県
松ケ浦駅	鹿児島県
松橋駅	熊本県
松原駅	長崎県
万ケ塚駅	宮崎県
御井駅	福岡県
三重町駅	大分県
三河内駅	長崎県
三毛門駅	福岡県
美咲が丘駅	福岡県
水城駅	福岡県
水成川駅	鹿児島県
水巻駅	福岡県
三角駅	熊本県
道ノ尾駅	長崎県
緑川駅	熊本県
南荒尾駅	熊本県
南大分駅	大分県
南鹿児島駅	鹿児島県
南方駅	宮崎県
南熊本駅	熊本県
南久留米駅	福岡県
南小倉駅	福岡県
南瀬高駅	福岡県
南延岡駅	宮崎県
南日向駅	宮崎県
南福岡駅	福岡県
南宮崎駅	宮崎県
南行橋駅	福岡県
南由布駅	大分県
三間坂駅	佐賀県
三股駅	宮崎県
美々津駅	宮崎県
宮ケ浜駅	鹿児島県
都城駅	宮崎県
宮崎駅	宮崎県
宮崎空港駅	宮崎県
宮崎神宮駅	宮崎県
宮地駅	熊本県
向之原駅	大分県
武蔵塚駅	熊本県
姪浜駅	福岡県
門司駅	福岡県
門司港駅	福岡県
餅原駅	宮崎県
桃川駅	佐賀県
矢岳駅	熊本県
八代駅	熊本県
柳ケ浦駅	大分県
八幡駅	福岡県
山川駅	鹿児島県
山之口駅	宮崎県
山本駅	佐賀県
弥生が丘駅	佐賀県
湯江駅	長崎県
行橋駅	福岡県
柚須駅	福岡県
湯平駅	大分県
湯之元駅	鹿児島県
由布院駅	大分県
夜明駅	大分県
暘谷駅	大分県
吉尾駅	熊本県
吉塚駅	福岡県
吉野駅	福岡県
吉野ケ里公園駅	佐賀県
吉松駅	鹿児島県
呼野駅	福岡県
榎原駅	宮崎県
竜ケ水駅	鹿児島県
若松駅	福岡県
和白駅	福岡県
渡瀬駅	福岡県
和多田駅	佐賀県
渡駅	熊本県
